Position,Classification code,Current Step,current_monthly,monthly_pay_at_contract_end,difference in monthly pay,pct_change
Accountant 1,1316,1,4155,5168,1013,24.38%
Accountant 1,1316,2,4356,5418,1062,24.38%
Accountant 1,1316,3,4555,5666,1111,24.39%
Accountant 1,1316,4,4776,5941,1165,24.39%
Accountant 1,1316,5,5019,6243,1224,24.39%
Accountant 1,1316,6,5256,6538,1282,24.39%
Accountant 1,1316,7,5503,6845,1342,24.39%
Accountant 1,1316,8,5771,7178,1407,24.38%
Accountant 1,1316,9,6051,7189,1138,18.81%
Accountant 1,1316,10,6350,7205,855,13.46%
Accountant 2,1317,1,5019,6243,1224,24.39%
Accountant 2,1317,2,5256,6538,1282,24.39%
Accountant 2,1317,3,5503,6845,1342,24.39%
Accountant 2,1317,4,5771,7178,1407,24.38%
Accountant 2,1317,5,6051,7527,1476,24.39%
Accountant 2,1317,6,6350,7898,1548,24.38%
Accountant 2,1317,7,6664,8289,1625,24.38%
Accountant 2,1317,8,6982,8685,1703,24.39%
Accountant 2,1317,9,7327,8705,1378,18.81%
Accountant 2,1317,10,7678,8712,1034,13.47%
Accountant 3,1318,1,5771,7178,1407,24.38%
Accountant 3,1318,2,6051,7527,1476,24.39%
Accountant 3,1318,3,6350,7898,1548,24.38%
Accountant 3,1318,4,6664,8289,1625,24.38%
Accountant 3,1318,5,6982,8685,1703,24.39%
Accountant 3,1318,6,7327,9114,1787,24.39%
Accountant 3,1318,7,7678,9550,1872,24.38%
Accountant 3,1318,8,8057,10022,1965,24.39%
Accountant 3,1318,9,8450,10039,1589,18.80%
Accountant 3,1318,10,8870,10065,1195,13.47%
Accounting Technician,313,1,3483,4332,849,24.38%
Accounting Technician,313,2,3629,4514,885,24.39%
Accounting Technician,313,3,3790,4714,924,24.38%
Accounting Technician,313,4,3964,4930,966,24.37%
Accounting Technician,313,5,4155,5168,1013,24.38%
Accounting Technician,313,6,4356,5418,1062,24.38%
Accounting Technician,313,7,4555,5666,1111,24.39%
Accounting Technician,313,8,4776,5941,1165,24.39%
Accounting Technician,313,9,5019,5963,944,18.81%
Accounting Technician,313,10,5256,5964,708,13.47%
Activities Coordinator,6530,1,3483,4536,1053,30.23%
Activities Coordinator,6530,2,3629,4514,885,24.39%
Activities Coordinator,6530,3,3790,4714,924,24.38%
Activities Coordinator,6530,4,3964,4930,966,24.37%
Activities Coordinator,6530,5,4155,5168,1013,24.38%
Activities Coordinator,6530,6,4356,5418,1062,24.38%
Activities Coordinator,6530,7,4555,5666,1111,24.39%
Activities Coordinator,6530,8,4776,5941,1165,24.39%
Activities Coordinator,6530,9,5019,5963,944,18.81%
Activities Coordinator,6530,10,5256,5964,708,13.47%
Administrative Law Judge 1,1510,1,5771,7178,1407,24.38%
Administrative Law Judge 1,1510,2,6051,7527,1476,24.39%
Administrative Law Judge 1,1510,3,6350,7898,1548,24.38%
Administrative Law Judge 1,1510,4,6664,8289,1625,24.38%
Administrative Law Judge 1,1510,5,6982,8685,1703,24.39%
Administrative Law Judge 1,1510,6,7327,9114,1787,24.39%
Administrative Law Judge 1,1510,7,7678,9550,1872,24.38%
Administrative Law Judge 1,1510,8,8057,10022,1965,24.39%
Administrative Law Judge 1,1510,9,8450,10039,1589,18.80%
Administrative Law Judge 1,1510,10,8870,10065,1195,13.47%
Administrative Law Judge 2,1511,1,6664,8289,1625,24.38%
Administrative Law Judge 2,1511,2,6982,8685,1703,24.39%
Administrative Law Judge 2,1511,3,7327,9114,1787,24.39%
Administrative Law Judge 2,1511,4,7678,9550,1872,24.38%
Administrative Law Judge 2,1511,5,8057,10022,1965,24.39%
Administrative Law Judge 2,1511,6,8450,10511,2061,24.39%
Administrative Law Judge 2,1511,7,8870,11033,2163,24.39%
Administrative Law Judge 2,1511,8,9293,11559,2266,24.38%
Administrative Law Judge 2,1511,9,9751,11585,1834,18.81%
Administrative Law Judge 2,1511,10,10242,11622,1380,13.47%
Administrative Law Judge 3,1513,1,8057,10022,1965,24.39%
Administrative Law Judge 3,1513,2,8450,10511,2061,24.39%
Administrative Law Judge 3,1513,3,8870,11033,2163,24.39%
Administrative Law Judge 3,1513,4,9293,11559,2266,24.38%
Administrative Law Judge 3,1513,5,9751,12129,2378,24.39%
Administrative Law Judge 3,1513,6,10242,12740,2498,24.39%
Administrative Law Judge 3,1513,7,10740,13359,2619,24.39%
Administrative Law Judge 3,1513,8,11267,14015,2748,24.39%
Administrative Law Judge 3,1513,9,11825,14049,2224,18.81%
Administrative Law Judge 3,1513,10,12408,14080,1672,13.48%
Administrative Specialist 1,107,1,3218,4002,784,24.36%
Administrative Specialist 1,107,2,3335,4148,813,24.38%
Administrative Specialist 1,107,3,3483,4332,849,24.38%
Administrative Specialist 1,107,4,3629,4514,885,24.39%
Administrative Specialist 1,107,5,3790,4714,924,24.38%
Administrative Specialist 1,107,6,3964,4930,966,24.37%
Administrative Specialist 1,107,7,4155,5168,1013,24.38%
Administrative Specialist 1,107,8,4356,5418,1062,24.38%
Administrative Specialist 1,107,9,4555,5411,856,18.79%
Administrative Specialist 1,107,10,4776,5419,643,13.46%
Administrative Specialist 2,108,1,3629,4514,885,24.39%
Administrative Specialist 2,108,2,3790,4714,924,24.38%
Administrative Specialist 2,108,3,3964,4930,966,24.37%
Administrative Specialist 2,108,4,4155,5168,1013,24.38%
Administrative Specialist 2,108,5,4356,5418,1062,24.38%
Administrative Specialist 2,108,6,4555,5666,1111,24.39%
Administrative Specialist 2,108,7,4776,5941,1165,24.39%
Administrative Specialist 2,108,8,5019,6243,1224,24.39%
Administrative Specialist 2,108,9,5256,6244,988,18.80%
Administrative Specialist 2,108,10,5503,6244,741,13.47%
Adult Protective Service Specialist,6616,1,4555,5666,1111,24.39%
Adult Protective Service Specialist,6616,1,4555,5666,1111,24.39%
Adult Protective Service Specialist,6616,2,4776,5941,1165,24.39%
Adult Protective Service Specialist,6616,2,4776,5941,1165,24.39%
Adult Protective Service Specialist,6616,3,5019,6243,1224,24.39%
Adult Protective Service Specialist,6616,3,5019,6243,1224,24.39%
Adult Protective Service Specialist,6616,4,5256,6538,1282,24.39%
Adult Protective Service Specialist,6616,4,5256,6538,1282,24.39%
Adult Protective Service Specialist,6616,5,5503,6845,1342,24.39%
Adult Protective Service Specialist,6616,5,5503,6845,1342,24.39%
Adult Protective Service Specialist,6616,6,5771,7178,1407,24.38%
Adult Protective Service Specialist,6616,6,5771,7178,1407,24.38%
Adult Protective Service Specialist,6616,7,6051,7527,1476,24.39%
Adult Protective Service Specialist,6616,7,6051,7527,1476,24.39%
Adult Protective Service Specialist,6616,8,6350,7898,1548,24.38%
Adult Protective Service Specialist,6616,8,6350,7898,1548,24.38%
Adult Protective Service Specialist,6616,9,6664,7917,1253,18.80%
Adult Protective Service Specialist,6616,9,6664,7917,1253,18.80%
Adult Protective Service Specialist,6616,10,6982,7922,940,13.46%
Adult Protective Service Specialist,6616,10,6982,7922,940,13.46%
Aerial Photographer,3540,1,4356,5418,1062,24.38%
Aerial Photographer,3540,2,4555,5666,1111,24.39%
Aerial Photographer,3540,3,4776,5941,1165,24.39%
Aerial Photographer,3540,4,5019,6243,1224,24.39%
Aerial Photographer,3540,5,5256,6538,1282,24.39%
Aerial Photographer,3540,6,5503,6845,1342,24.39%
Aerial Photographer,3540,7,5771,7178,1407,24.38%
Aerial Photographer,3540,8,6051,7527,1476,24.39%
Aerial Photographer,3540,9,6350,7544,1194,18.80%
Aerial Photographer,3540,10,6664,7562,898,13.48%
Aircraft Pilot,8333,1,5019,6243,1224,24.39%
Aircraft Pilot,8333,2,5256,6538,1282,24.39%
Aircraft Pilot,8333,3,5503,6845,1342,24.39%
Aircraft Pilot,8333,4,5771,7178,1407,24.38%
Aircraft Pilot,8333,5,6051,7527,1476,24.39%
Aircraft Pilot,8333,6,6350,7898,1548,24.38%
Aircraft Pilot,8333,7,6664,8289,1625,24.38%
Aircraft Pilot,8333,8,6982,8685,1703,24.39%
Aircraft Pilot,8333,9,7327,8705,1378,18.81%
Aircraft Pilot,8333,10,7678,8712,1034,13.47%
Appraiser Analyst 1,735,1,3335,4148,813,24.38%
Appraiser Analyst 1,735,2,3483,4332,849,24.38%
Appraiser Analyst 1,735,3,3629,4514,885,24.39%
Appraiser Analyst 1,735,4,3790,4714,924,24.38%
Appraiser Analyst 1,735,5,3964,4930,966,24.37%
Appraiser Analyst 1,735,6,4155,5168,1013,24.38%
Appraiser Analyst 1,735,7,4356,5418,1062,24.38%
Appraiser Analyst 1,735,8,4555,5666,1111,24.39%
Appraiser Analyst 1,735,9,4776,5674,898,18.80%
Appraiser Analyst 1,735,10,5019,5695,676,13.47%
Appraiser Analyst 2,736,1,4555,5666,1111,24.39%
Appraiser Analyst 2,736,2,4776,5941,1165,24.39%
Appraiser Analyst 2,736,3,5019,6243,1224,24.39%
Appraiser Analyst 2,736,4,5256,6538,1282,24.39%
Appraiser Analyst 2,736,5,5503,6845,1342,24.39%
Appraiser Analyst 2,736,6,5771,7178,1407,24.38%
Appraiser Analyst 2,736,7,6051,7527,1476,24.39%
Appraiser Analyst 2,736,8,6350,7898,1548,24.38%
Appraiser Analyst 2,736,9,6664,7917,1253,18.80%
Appraiser Analyst 2,736,10,6982,7922,940,13.46%
Appraiser Analyst 3,737,1,5256,6538,1282,24.39%
Appraiser Analyst 3,737,2,5503,6845,1342,24.39%
Appraiser Analyst 3,737,3,5771,7178,1407,24.38%
Appraiser Analyst 3,737,4,6051,7527,1476,24.39%
Appraiser Analyst 3,737,5,6350,7898,1548,24.38%
Appraiser Analyst 3,737,6,6664,8289,1625,24.38%
Appraiser Analyst 3,737,7,6982,8685,1703,24.39%
Appraiser Analyst 3,737,8,7327,9114,1787,24.39%
Appraiser Analyst 3,737,9,7678,9122,1444,18.81%
Appraiser Analyst 3,737,10,8057,9142,1085,13.47%
Appraiser Analyst 4,738,1,6051,7527,1476,24.39%
Appraiser Analyst 4,738,2,6350,7898,1548,24.38%
Appraiser Analyst 4,738,3,6664,8289,1625,24.38%
Appraiser Analyst 4,738,4,6982,8685,1703,24.39%
Appraiser Analyst 4,738,5,7327,9114,1787,24.39%
Appraiser Analyst 4,738,6,7678,9550,1872,24.38%
Appraiser Analyst 4,738,7,8057,10022,1965,24.39%
Appraiser Analyst 4,738,8,8450,10511,2061,24.39%
Appraiser Analyst 4,738,9,8870,10538,1668,18.80%
Appraiser Analyst 4,738,10,9293,10545,1252,13.47%
Apprenticeship Representative,4380,1,4155,5168,1013,24.38%
Apprenticeship Representative,4380,2,4356,5418,1062,24.38%
Apprenticeship Representative,4380,3,4555,5666,1111,24.39%
Apprenticeship Representative,4380,4,4776,5941,1165,24.39%
Apprenticeship Representative,4380,5,5019,6243,1224,24.39%
Apprenticeship Representative,4380,6,5256,6538,1282,24.39%
Apprenticeship Representative,4380,7,5503,6845,1342,24.39%
Apprenticeship Representative,4380,8,5771,7178,1407,24.38%
Apprenticeship Representative,4380,9,6051,7189,1138,18.81%
Apprenticeship Representative,4380,10,6350,7205,855,13.46%
Automotive Fleet Attendant,4417,1,0,0,0,
Automotive Fleet Attendant,4417,2,3005,3738,733,24.39%
Automotive Fleet Attendant,4417,3,3095,3849,754,24.36%
Automotive Fleet Attendant,4417,4,3218,4002,784,24.36%
Automotive Fleet Attendant,4417,5,3335,4148,813,24.38%
Automotive Fleet Attendant,4417,6,3483,4332,849,24.38%
Automotive Fleet Attendant,4417,7,3629,4514,885,24.39%
Automotive Fleet Attendant,4417,8,3790,4714,924,24.38%
Automotive Fleet Attendant,4417,9,3964,4709,745,18.79%
Automotive Fleet Attendant,4417,10,4155,4714,559,13.45%
Automotive Technician 1,4418,1,3483,4332,849,24.38%
Automotive Technician 1,4418,2,3629,4514,885,24.39%
Automotive Technician 1,4418,3,3790,4714,924,24.38%
Automotive Technician 1,4418,4,3964,4930,966,24.37%
Automotive Technician 1,4418,5,4155,5168,1013,24.38%
Automotive Technician 1,4418,6,4356,5418,1062,24.38%
Automotive Technician 1,4418,7,4555,5666,1111,24.39%
Automotive Technician 1,4418,8,4776,5941,1165,24.39%
Automotive Technician 1,4418,9,5019,5963,944,18.81%
Automotive Technician 1,4418,10,5256,5964,708,13.47%
Automotive Technician 2,4419,1,4155,5168,1013,24.38%
Automotive Technician 2,4419,2,4356,5418,1062,24.38%
Automotive Technician 2,4419,3,4555,5666,1111,24.39%
Automotive Technician 2,4419,4,4776,5941,1165,24.39%
Automotive Technician 2,4419,5,5019,6243,1224,24.39%
Automotive Technician 2,4419,6,5256,6538,1282,24.39%
Automotive Technician 2,4419,7,5503,6845,1342,24.39%
Automotive Technician 2,4419,8,5771,7178,1407,24.38%
Automotive Technician 2,4419,9,6051,7189,1138,18.81%
Automotive Technician 2,4419,10,6350,7205,855,13.46%
Behavioral Health Specialist 1,6531,1,4356,5418,1062,24.38%
Behavioral Health Specialist 1,6531,2,4555,5666,1111,24.39%
Behavioral Health Specialist 1,6531,3,4776,5941,1165,24.39%
Behavioral Health Specialist 1,6531,4,5019,6243,1224,24.39%
Behavioral Health Specialist 1,6531,5,5256,6538,1282,24.39%
Behavioral Health Specialist 1,6531,6,5503,6845,1342,24.39%
Behavioral Health Specialist 1,6531,7,5771,7178,1407,24.38%
Behavioral Health Specialist 1,6531,8,6051,7527,1476,24.39%
Behavioral Health Specialist 1,6531,9,6350,7544,1194,18.80%
Behavioral Health Specialist 1,6531,10,6664,7562,898,13.48%
Behavioral Health Specialist 2,6534,1,5019,6243,1224,24.39%
Behavioral Health Specialist 2,6534,2,5256,6538,1282,24.39%
Behavioral Health Specialist 2,6534,3,5503,6845,1342,24.39%
Behavioral Health Specialist 2,6534,4,5771,7178,1407,24.38%
Behavioral Health Specialist 2,6534,5,6051,7527,1476,24.39%
Behavioral Health Specialist 2,6534,6,6350,7898,1548,24.38%
Behavioral Health Specialist 2,6534,7,6664,8289,1625,24.38%
Behavioral Health Specialist 2,6534,8,6982,8685,1703,24.39%
Behavioral Health Specialist 2,6534,9,7327,8705,1378,18.81%
Behavioral Health Specialist 2,6534,10,7678,8712,1034,13.47%
Behavioral Health Specialist 3,6535,1,5503,6845,1342,24.39%
Behavioral Health Specialist 3,6535,2,5771,7178,1407,24.38%
Behavioral Health Specialist 3,6535,3,6051,7527,1476,24.39%
Behavioral Health Specialist 3,6535,4,6350,7898,1548,24.38%
Behavioral Health Specialist 3,6535,5,6664,8289,1625,24.38%
Behavioral Health Specialist 3,6535,6,6982,8685,1703,24.39%
Behavioral Health Specialist 3,6535,7,7327,9114,1787,24.39%
Behavioral Health Specialist 3,6535,8,7678,9550,1872,24.38%
Behavioral Health Specialist 3,6535,9,8057,9572,1515,18.80%
Behavioral Health Specialist 3,6535,10,8450,9588,1138,13.47%
Biological Science Assistant,3769,1,0,0,0,
Biological Science Assistant,3769,2,0,0,0,
Biological Science Assistant,3769,3,0,0,0,
Biological Science Assistant,3769,4,3005,3738,733,24.39%
Biological Science Assistant,3769,5,3095,3849,754,24.36%
Biological Science Assistant,3769,6,3218,4002,784,24.36%
Biological Science Assistant,3769,7,3335,4148,813,24.38%
Biological Science Assistant,3769,8,3483,4332,849,24.38%
Biological Science Assistant,3769,9,3629,4311,682,18.79%
Biological Science Assistant,3769,10,3790,4300,510,13.46%
Business & Employment Specialist 2,6699,1,3790,4714,924,24.38%
Business & Employment Specialist 2,6699,2,3964,4930,966,24.37%
Business & Employment Specialist 2,6699,3,4155,5168,1013,24.38%
Business & Employment Specialist 2,6699,4,4356,5418,1062,24.38%
Business & Employment Specialist 2,6699,5,4555,5666,1111,24.39%
Business & Employment Specialist 2,6699,6,4776,5941,1165,24.39%
Business & Employment Specialist 2,6699,7,5019,6243,1224,24.39%
Business & Employment Specialist 2,6699,8,5256,6538,1282,24.39%
Business & Employment Specialist 2,6699,9,5503,6538,1035,18.81%
Business & Employment Specialist 2,6699,10,5771,6548,777,13.46%
Carpenter,4003,1,3964,4930,966,24.37%
Carpenter,4003,2,4155,5168,1013,24.38%
Carpenter,4003,3,4356,5418,1062,24.38%
Carpenter,4003,4,4555,5666,1111,24.39%
Carpenter,4003,5,4776,5941,1165,24.39%
Carpenter,4003,6,5019,6243,1224,24.39%
Carpenter,4003,7,5256,6538,1282,24.39%
Carpenter,4003,8,5503,6845,1342,24.39%
Carpenter,4003,9,5771,6856,1085,18.80%
Carpenter,4003,10,6051,6866,815,13.47%
Certified Occupation Therapist Assistant,6506,1,3629,4726,1097,30.23%
Certified Occupation Therapist Assistant,6506,2,3790,4714,924,24.38%
Certified Occupation Therapist Assistant,6506,3,3964,4930,966,24.37%
Certified Occupation Therapist Assistant,6506,4,4155,5168,1013,24.38%
Certified Occupation Therapist Assistant,6506,5,4356,5418,1062,24.38%
Certified Occupation Therapist Assistant,6506,6,4555,5666,1111,24.39%
Certified Occupation Therapist Assistant,6506,7,4776,5941,1165,24.39%
Certified Occupation Therapist Assistant,6506,8,5019,6243,1224,24.39%
Certified Occupation Therapist Assistant,6506,9,5256,6244,988,18.80%
Certified Occupation Therapist Assistant,6506,10,5503,6244,741,13.47%
Chaplain,6680,1,4356,5418,1062,24.38%
Chaplain,6680,2,4555,5666,1111,24.39%
Chaplain,6680,3,4776,5941,1165,24.39%
Chaplain,6680,4,5019,6243,1224,24.39%
Chaplain,6680,5,5256,6538,1282,24.39%
Chaplain,6680,6,5503,6845,1342,24.39%
Chaplain,6680,7,5771,7178,1407,24.38%
Chaplain,6680,8,6051,7527,1476,24.39%
Chaplain,6680,9,6350,7544,1194,18.80%
Chaplain,6680,10,6664,7562,898,13.48%
Chemist 1,3715,1,4356,5418,1062,24.38%
Chemist 1,3715,2,4555,5666,1111,24.39%
Chemist 1,3715,3,4776,5941,1165,24.39%
Chemist 1,3715,4,5019,6243,1224,24.39%
Chemist 1,3715,5,5256,6538,1282,24.39%
Chemist 1,3715,6,5503,6845,1342,24.39%
Chemist 1,3715,7,5771,7178,1407,24.38%
Chemist 1,3715,8,6051,7527,1476,24.39%
Chemist 1,3715,9,6350,7544,1194,18.80%
Chemist 1,3715,10,6664,7562,898,13.48%
Chemist 2,3716,1,4776,5941,1165,24.39%
Chemist 2,3716,2,5019,6243,1224,24.39%
Chemist 2,3716,3,5256,6538,1282,24.39%
Chemist 2,3716,4,5503,6845,1342,24.39%
Chemist 2,3716,5,5771,7178,1407,24.38%
Chemist 2,3716,6,6051,7527,1476,24.39%
Chemist 2,3716,7,6350,7898,1548,24.38%
Chemist 2,3716,8,6664,8289,1625,24.38%
Chemist 2,3716,9,6982,8295,1313,18.81%
Chemist 2,3716,10,7327,8314,987,13.47%
Chemist 3,3717,1,5503,6845,1342,24.39%
Chemist 3,3717,2,5771,7178,1407,24.38%
Chemist 3,3717,3,6051,7527,1476,24.39%
Chemist 3,3717,4,6350,7898,1548,24.38%
Chemist 3,3717,5,6664,8289,1625,24.38%
Chemist 3,3717,6,6982,8685,1703,24.39%
Chemist 3,3717,7,7327,9114,1787,24.39%
Chemist 3,3717,8,7678,9550,1872,24.38%
Chemist 3,3717,9,8057,9572,1515,18.80%
Chemist 3,3717,10,8450,9588,1138,13.47%
Child Nutrition Specialist,5950,1,5256,6538,1282,24.39%
Child Nutrition Specialist,5950,2,5503,6845,1342,24.39%
Child Nutrition Specialist,5950,3,5771,7178,1407,24.38%
Child Nutrition Specialist,5950,4,6051,7527,1476,24.39%
Child Nutrition Specialist,5950,5,6350,7898,1548,24.38%
Child Nutrition Specialist,5950,6,6664,8289,1625,24.38%
Child Nutrition Specialist,5950,7,6982,8685,1703,24.39%
Child Nutrition Specialist,5950,8,7327,9114,1787,24.39%
Child Nutrition Specialist,5950,9,7678,9122,1444,18.81%
Child Nutrition Specialist,5950,10,8057,9142,1085,13.47%
Child Support Case Manager,5139,1,3790,4714,924,24.38%
Child Support Case Manager,5139,2,3964,4930,966,24.37%
Child Support Case Manager,5139,3,4155,5168,1013,24.38%
Child Support Case Manager,5139,4,4356,5418,1062,24.38%
Child Support Case Manager,5139,5,4555,5666,1111,24.39%
Child Support Case Manager,5139,6,4776,5941,1165,24.39%
Child Support Case Manager,5139,7,5019,6243,1224,24.39%
Child Support Case Manager,5139,8,5256,6538,1282,24.39%
Child Support Case Manager,5139,9,5503,6538,1035,18.81%
Child Support Case Manager,5139,10,5771,6548,777,13.46%
Child Support Case Manager Entry,5138,1,3483,4332,849,24.38%
Child Support Case Manager Entry,5138,2,3629,4514,885,24.39%
Child Support Case Manager Entry,5138,3,3790,4714,924,24.38%
Child Support Case Manager Entry,5138,4,3964,4930,966,24.37%
Child Support Case Manager Entry,5138,5,4155,5168,1013,24.38%
Child Support Case Manager Entry,5138,6,4356,5418,1062,24.38%
Child Support Case Manager Entry,5138,7,4555,5666,1111,24.39%
Child Support Case Manager Entry,5138,8,4776,5941,1165,24.39%
Child Support Case Manager Entry,5138,9,5019,5963,944,18.81%
Child Support Case Manager Entry,5138,10,5256,5964,708,13.47%
Child Support Specialist,5133,1,4155,5168,1013,24.38%
Child Support Specialist,5133,2,4356,5418,1062,24.38%
Child Support Specialist,5133,3,4555,5666,1111,24.39%
Child Support Specialist,5133,4,4776,5941,1165,24.39%
Child Support Specialist,5133,5,5019,6243,1224,24.39%
Child Support Specialist,5133,6,5256,6538,1282,24.39%
Child Support Specialist,5133,7,5503,6845,1342,24.39%
Child Support Specialist,5133,8,5771,7178,1407,24.38%
Child Support Specialist,5133,9,6051,7189,1138,18.81%
Child Support Specialist,5133,10,6350,7205,855,13.46%
Civil Engineering Specialist 1,3136,1,4555,5666,1111,24.39%
Civil Engineering Specialist 1,3136,2,4776,5941,1165,24.39%
Civil Engineering Specialist 1,3136,3,5019,6243,1224,24.39%
Civil Engineering Specialist 1,3136,4,5256,6538,1282,24.39%
Civil Engineering Specialist 1,3136,5,5503,6845,1342,24.39%
Civil Engineering Specialist 1,3136,6,5771,7178,1407,24.38%
Civil Engineering Specialist 1,3136,7,6051,7527,1476,24.39%
Civil Engineering Specialist 1,3136,8,6350,7898,1548,24.38%
Civil Engineering Specialist 1,3136,9,6664,7917,1253,18.80%
Civil Engineering Specialist 1,3136,10,6982,7922,940,13.46%
Civil Rights Investigator 1,5340,1,3790,4714,924,24.38%
Civil Rights Investigator 1,5340,2,3964,4930,966,24.37%
Civil Rights Investigator 1,5340,3,4155,5168,1013,24.38%
Civil Rights Investigator 1,5340,4,4356,5418,1062,24.38%
Civil Rights Investigator 1,5340,5,4555,5666,1111,24.39%
Civil Rights Investigator 1,5340,6,4776,5941,1165,24.39%
Civil Rights Investigator 1,5340,7,5019,6243,1224,24.39%
Civil Rights Investigator 1,5340,8,5256,6538,1282,24.39%
Civil Rights Investigator 1,5340,9,5503,6538,1035,18.81%
Civil Rights Investigator 1,5340,10,5771,6548,777,13.46%
Civil Rights Investigator 2,5341,1,4776,5941,1165,24.39%
Civil Rights Investigator 2,5341,2,5019,6243,1224,24.39%
Civil Rights Investigator 2,5341,3,5256,6538,1282,24.39%
Civil Rights Investigator 2,5341,4,5503,6845,1342,24.39%
Civil Rights Investigator 2,5341,5,5771,7178,1407,24.38%
Civil Rights Investigator 2,5341,6,6051,7527,1476,24.39%
Civil Rights Investigator 2,5341,7,6350,7898,1548,24.38%
Civil Rights Investigator 2,5341,8,6664,8289,1625,24.38%
Civil Rights Investigator 2,5341,9,6982,8295,1313,18.81%
Civil Rights Investigator 2,5341,10,7327,8314,987,13.47%
Claims Representative 1,5307,1,3964,4930,966,24.37%
Claims Representative 1,5307,2,4155,5168,1013,24.38%
Claims Representative 1,5307,3,4356,5418,1062,24.38%
Claims Representative 1,5307,4,4555,5666,1111,24.39%
Claims Representative 1,5307,5,4776,5941,1165,24.39%
Claims Representative 1,5307,6,5019,6243,1224,24.39%
Claims Representative 1,5307,7,5256,6538,1282,24.39%
Claims Representative 1,5307,8,5503,6845,1342,24.39%
Claims Representative 1,5307,9,5771,6856,1085,18.80%
Claims Representative 1,5307,10,6051,6866,815,13.47%
Claims Representative 2,5308,1,4356,5418,1062,24.38%
Claims Representative 2,5308,2,4555,5666,1111,24.39%
Claims Representative 2,5308,3,4776,5941,1165,24.39%
Claims Representative 2,5308,4,5019,6243,1224,24.39%
Claims Representative 2,5308,5,5256,6538,1282,24.39%
Claims Representative 2,5308,6,5503,6845,1342,24.39%
Claims Representative 2,5308,7,5771,7178,1407,24.38%
Claims Representative 2,5308,8,6051,7527,1476,24.39%
Claims Representative 2,5308,9,6350,7544,1194,18.80%
Claims Representative 2,5308,10,6664,7562,898,13.48%
Client Care Surveyor,6685,1,5256,6538,1282,24.39%
Client Care Surveyor,6685,2,5503,6845,1342,24.39%
Client Care Surveyor,6685,3,5771,7178,1407,24.38%
Client Care Surveyor,6685,4,6051,7527,1476,24.39%
Client Care Surveyor,6685,5,6350,7898,1548,24.38%
Client Care Surveyor,6685,6,6664,8289,1625,24.38%
Client Care Surveyor,6685,7,6982,8685,1703,24.39%
Client Care Surveyor,6685,8,7327,9114,1787,24.39%
Client Care Surveyor,6685,9,7678,9122,1444,18.81%
Client Care Surveyor,6685,10,8057,9142,1085,13.47%
Clinical Laboratory Scientist,6833,1,4356,5418,1062,24.38%
Clinical Laboratory Scientist,6833,2,4555,5666,1111,24.39%
Clinical Laboratory Scientist,6833,3,4776,5941,1165,24.39%
Clinical Laboratory Scientist,6833,4,5019,6243,1224,24.39%
Clinical Laboratory Scientist,6833,5,5256,6538,1282,24.39%
Clinical Laboratory Scientist,6833,6,5503,6845,1342,24.39%
Clinical Laboratory Scientist,6833,7,5771,7178,1407,24.38%
Clinical Laboratory Scientist,6833,8,6051,7527,1476,24.39%
Clinical Laboratory Scientist,6833,9,6350,7544,1194,18.80%
Clinical Laboratory Scientist,6833,10,6664,7562,898,13.48%
Clinical Psychologist 1,6394,1,6664,8289,1625,24.38%
Clinical Psychologist 1,6394,2,6982,8685,1703,24.39%
Clinical Psychologist 1,6394,3,7327,9114,1787,24.39%
Clinical Psychologist 1,6394,4,7678,9550,1872,24.38%
Clinical Psychologist 1,6394,5,8057,10022,1965,24.39%
Clinical Psychologist 1,6394,6,8450,10511,2061,24.39%
Clinical Psychologist 1,6394,7,8870,11033,2163,24.39%
Clinical Psychologist 1,6394,8,9293,11559,2266,24.38%
Clinical Psychologist 1,6394,9,9751,11585,1834,18.81%
Clinical Psychologist 1,6394,10,10242,11622,1380,13.47%
Clinical Psychologist 2,6395,1,7327,9114,1787,24.39%
Clinical Psychologist 2,6395,2,7678,9550,1872,24.38%
Clinical Psychologist 2,6395,3,8057,10022,1965,24.39%
Clinical Psychologist 2,6395,4,8450,10511,2061,24.39%
Clinical Psychologist 2,6395,5,8870,11033,2163,24.39%
Clinical Psychologist 2,6395,6,9293,11559,2266,24.38%
Clinical Psychologist 2,6395,7,9751,12129,2378,24.39%
Clinical Psychologist 2,6395,8,10242,12740,2498,24.39%
Clinical Psychologist 2,6395,9,10740,12760,2020,18.81%
Clinical Psychologist 2,6395,10,11267,12785,1518,13.47%
Communicable Disease Analyst,5903,1,3964,4930,966,24.37%
Communicable Disease Analyst,5903,2,4155,5168,1013,24.38%
Communicable Disease Analyst,5903,3,4356,5418,1062,24.38%
Communicable Disease Analyst,5903,4,4555,5666,1111,24.39%
Communicable Disease Analyst,5903,5,4776,5941,1165,24.39%
Communicable Disease Analyst,5903,6,5019,6243,1224,24.39%
Communicable Disease Analyst,5903,7,5256,6538,1282,24.39%
Communicable Disease Analyst,5903,8,5503,6845,1342,24.39%
Communicable Disease Analyst,5903,9,5771,6856,1085,18.80%
Communicable Disease Analyst,5903,10,6051,6866,815,13.47%
Community Outreach Specialist,6614,1,4776,5941,1165,24.39%
Community Outreach Specialist,6614,2,5019,6243,1224,24.39%
Community Outreach Specialist,6614,3,5256,6538,1282,24.39%
Community Outreach Specialist,6614,4,5503,6845,1342,24.39%
Community Outreach Specialist,6614,5,5771,7178,1407,24.38%
Community Outreach Specialist,6614,6,6051,7527,1476,24.39%
Community Outreach Specialist,6614,7,6350,7898,1548,24.38%
Community Outreach Specialist,6614,8,6664,8289,1625,24.38%
Community Outreach Specialist,6614,9,6982,8295,1313,18.81%
Community Outreach Specialist,6614,10,7327,8314,987,13.47%
Compliance Specialist 1,5346,1,3790,4714,924,24.38%
Compliance Specialist 1,5346,1,3790,4714,924,24.38%
Compliance Specialist 1,5346,2,3964,4930,966,24.37%
Compliance Specialist 1,5346,2,3964,4930,966,24.37%
Compliance Specialist 1,5346,3,4155,5168,1013,24.38%
Compliance Specialist 1,5346,3,4155,5168,1013,24.38%
Compliance Specialist 1,5346,4,4356,5418,1062,24.38%
Compliance Specialist 1,5346,4,4356,5418,1062,24.38%
Compliance Specialist 1,5346,5,4555,5666,1111,24.39%
Compliance Specialist 1,5346,5,4555,5666,1111,24.39%
Compliance Specialist 1,5346,6,4776,5941,1165,24.39%
Compliance Specialist 1,5346,6,4776,5941,1165,24.39%
Compliance Specialist 1,5346,7,5019,6243,1224,24.39%
Compliance Specialist 1,5346,7,5019,6243,1224,24.39%
Compliance Specialist 1,5346,8,5256,6538,1282,24.39%
Compliance Specialist 1,5346,8,5256,6538,1282,24.39%
Compliance Specialist 1,5346,9,5503,6538,1035,18.81%
Compliance Specialist 1,5346,9,5503,6538,1035,18.81%
Compliance Specialist 1,5346,10,5771,6548,777,13.46%
Compliance Specialist 1,5346,10,5771,6548,777,13.46%
Compliance Specialist 2,5347,1,4555,5666,1111,24.39%
Compliance Specialist 2,5347,1,4555,5666,1111,24.39%
Compliance Specialist 2,5347,2,4776,5941,1165,24.39%
Compliance Specialist 2,5347,2,4776,5941,1165,24.39%
Compliance Specialist 2,5347,3,5019,6243,1224,24.39%
Compliance Specialist 2,5347,3,5019,6243,1224,24.39%
Compliance Specialist 2,5347,4,5256,6538,1282,24.39%
Compliance Specialist 2,5347,4,5256,6538,1282,24.39%
Compliance Specialist 2,5347,5,5503,6845,1342,24.39%
Compliance Specialist 2,5347,5,5503,6845,1342,24.39%
Compliance Specialist 2,5347,6,5771,7178,1407,24.38%
Compliance Specialist 2,5347,6,5771,7178,1407,24.38%
Compliance Specialist 2,5347,7,6051,7527,1476,24.39%
Compliance Specialist 2,5347,7,6051,7527,1476,24.39%
Compliance Specialist 2,5347,8,6350,7898,1548,24.38%
Compliance Specialist 2,5347,8,6350,7898,1548,24.38%
Compliance Specialist 2,5347,9,6664,7917,1253,18.80%
Compliance Specialist 2,5347,9,6664,7917,1253,18.80%
Compliance Specialist 2,5347,10,6982,7922,940,13.46%
Compliance Specialist 2,5347,10,6982,7922,940,13.46%
Compliance Specialist 3,5348,1,5503,6845,1342,24.39%
Compliance Specialist 3,5348,2,5771,7178,1407,24.38%
Compliance Specialist 3,5348,3,6051,7527,1476,24.39%
Compliance Specialist 3,5348,4,6350,7898,1548,24.38%
Compliance Specialist 3,5348,5,6664,8289,1625,24.38%
Compliance Specialist 3,5348,6,6982,8685,1703,24.39%
Compliance Specialist 3,5348,7,7327,9114,1787,24.39%
Compliance Specialist 3,5348,8,7678,9550,1872,24.38%
Compliance Specialist 3,5348,9,8057,9572,1515,18.80%
Compliance Specialist 3,5348,10,8450,9588,1138,13.47%
Construction Inspector,3365,1,5019,6243,1224,24.39%
Construction Inspector,3365,2,5256,6538,1282,24.39%
Construction Inspector,3365,3,5503,6845,1342,24.39%
Construction Inspector,3365,4,5771,7178,1407,24.38%
Construction Inspector,3365,5,6051,7527,1476,24.39%
Construction Inspector,3365,6,6350,7898,1548,24.38%
Construction Inspector,3365,7,6664,8289,1625,24.38%
Construction Inspector,3365,8,6982,8685,1703,24.39%
Construction Inspector,3365,9,7327,8705,1378,18.81%
Construction Inspector,3365,10,7678,8712,1034,13.47%
Construction Project Manager 1,3367,1,5019,6243,1224,24.39%
Construction Project Manager 1,3367,2,5256,6538,1282,24.39%
Construction Project Manager 1,3367,3,5503,6845,1342,24.39%
Construction Project Manager 1,3367,4,5771,7178,1407,24.38%
Construction Project Manager 1,3367,5,6051,7527,1476,24.39%
Construction Project Manager 1,3367,6,6350,7898,1548,24.38%
Construction Project Manager 1,3367,7,6664,8289,1625,24.38%
Construction Project Manager 1,3367,8,6982,8685,1703,24.39%
Construction Project Manager 1,3367,9,7327,8705,1378,18.81%
Construction Project Manager 1,3367,10,7678,8712,1034,13.47%
Construction Project Manager 2,3368,1,5771,7178,1407,24.38%
Construction Project Manager 2,3368,2,6051,7527,1476,24.39%
Construction Project Manager 2,3368,3,6350,7898,1548,24.38%
Construction Project Manager 2,3368,4,6664,8289,1625,24.38%
Construction Project Manager 2,3368,5,6982,8685,1703,24.39%
Construction Project Manager 2,3368,6,7327,9114,1787,24.39%
Construction Project Manager 2,3368,7,7678,9550,1872,24.38%
Construction Project Manager 2,3368,8,8057,10022,1965,24.39%
Construction Project Manager 2,3368,9,8450,10039,1589,18.80%
Construction Project Manager 2,3368,10,8870,10065,1195,13.47%
Construction Project Manager 3,3369,1,6664,8289,1625,24.38%
Construction Project Manager 3,3369,2,6982,8685,1703,24.39%
Construction Project Manager 3,3369,3,7327,9114,1787,24.39%
Construction Project Manager 3,3369,4,7678,9550,1872,24.38%
Construction Project Manager 3,3369,5,8057,10022,1965,24.39%
Construction Project Manager 3,3369,6,8450,10511,2061,24.39%
Construction Project Manager 3,3369,7,8870,11033,2163,24.39%
Construction Project Manager 3,3369,8,9293,11559,2266,24.38%
Construction Project Manager 3,3369,9,9751,11585,1834,18.81%
Construction Project Manager 3,3369,10,10242,11622,1380,13.47%
Cook,9117,1,3218,4002,784,24.36%
Cook,9117,2,3335,4148,813,24.38%
Cook,9117,3,3483,4332,849,24.38%
Cook,9117,4,3629,4514,885,24.39%
Cook,9117,5,3790,4714,924,24.38%
Cook,9117,6,3964,4930,966,24.37%
Cook,9117,7,4155,5168,1013,24.38%
Cook,9117,8,4356,5418,1062,24.38%
Cook,9117,9,4555,5411,856,18.79%
Cook,9117,10,4776,5419,643,13.46%
Custodial Services Coordinator,4103,1,0,0,0,
Custodial Services Coordinator,4103,2,0,0,0,
Custodial Services Coordinator,4103,3,3005,3738,733,24.39%
Custodial Services Coordinator,4103,4,3095,3849,754,24.36%
Custodial Services Coordinator,4103,5,3218,4002,784,24.36%
Custodial Services Coordinator,4103,6,3335,4148,813,24.38%
Custodial Services Coordinator,4103,7,3483,4332,849,24.38%
Custodial Services Coordinator,4103,8,3629,4514,885,24.39%
Custodial Services Coordinator,4103,9,3790,4502,712,18.79%
Custodial Services Coordinator,4103,10,3964,4498,534,13.47%
Custodian,4101,1,0,0,0,
Custodian,4101,2,0,0,0,
Custodian,4101,3,0,0,0,
Custodian,4101,4,0,0,0,
Custodian,4101,5,0,0,0,
Custodian,4101,6,3005,3738,733,24.39%
Custodian,4101,7,3095,3849,754,24.36%
Custodian,4101,8,3218,4002,784,24.36%
Custodian,4101,9,3335,3962,627,18.80%
Custodian,4101,10,3483,3952,469,13.47%
Data Entry Control Technician,1475,1,0,0,0,
Data Entry Control Technician,1475,2,0,0,0,
Data Entry Control Technician,1475,3,0,0,0,
Data Entry Control Technician,1475,4,3005,3738,733,24.39%
Data Entry Control Technician,1475,5,3095,3849,754,24.36%
Data Entry Control Technician,1475,6,3218,4002,784,24.36%
Data Entry Control Technician,1475,7,3335,4148,813,24.38%
Data Entry Control Technician,1475,8,3483,4332,849,24.38%
Data Entry Control Technician,1475,9,3629,4311,682,18.79%
Data Entry Control Technician,1475,10,3790,4300,510,13.46%
Data Entry Operator,501,1,0,0,0,
Data Entry Operator,501,2,0,0,0,
Data Entry Operator,501,3,0,0,0,
Data Entry Operator,501,4,3005,3738,733,24.39%
Data Entry Operator,501,5,3095,3849,754,24.36%
Data Entry Operator,501,6,3218,4002,784,24.36%
Data Entry Operator,501,7,3335,4148,813,24.38%
Data Entry Operator,501,8,3483,4332,849,24.38%
Data Entry Operator,501,9,3629,4311,682,18.79%
Data Entry Operator,501,10,3790,4300,510,13.46%
Dental Assistant 2,6394,1,3629,4726,1097,30.23%
Dental Assistant 2,6394,2,3790,4714,924,24.38%
Dental Assistant 2,6394,3,3964,4930,966,24.37%
Dental Assistant 2,6394,4,4155,5168,1013,24.38%
Dental Assistant 2,6394,5,4356,5418,1062,24.38%
Dental Assistant 2,6394,6,4555,5666,1111,24.39%
Dental Assistant 2,6394,7,4776,5941,1165,24.39%
Dental Assistant 2,6394,8,5019,6243,1224,24.39%
Dental Assistant 2,6394,9,5256,6244,988,18.80%
Dental Assistant 2,6394,10,5503,6244,741,13.47%
Dental Hygienist,6396,1,5503,6845,1342,24.39%
Dental Hygienist,6396,2,5771,7178,1407,24.38%
Dental Hygienist,6396,3,6051,7527,1476,24.39%
Dental Hygienist,6396,4,6350,7898,1548,24.38%
Dental Hygienist,6396,5,6664,8289,1625,24.38%
Dental Hygienist,6396,6,6982,8685,1703,24.39%
Dental Hygienist,6396,7,7327,9114,1787,24.39%
Dental Hygienist,6396,8,7678,9550,1872,24.38%
Dental Hygienist,6396,9,8057,9572,1515,18.80%
Dental Hygienist,6396,10,8450,9588,1138,13.47%
Dietitian 2,6371,1,4776,5941,1165,24.39%
Dietitian 2,6371,2,5019,6243,1224,24.39%
Dietitian 2,6371,3,5256,6538,1282,24.39%
Dietitian 2,6371,4,5503,6845,1342,24.39%
Dietitian 2,6371,5,5771,7178,1407,24.38%
Dietitian 2,6371,6,6051,7527,1476,24.39%
Dietitian 2,6371,7,6350,7898,1548,24.38%
Dietitian 2,6371,8,6664,8289,1625,24.38%
Dietitian 2,6371,9,6982,8295,1313,18.81%
Dietitian 2,6371,10,7327,8314,987,13.47%
Disability Analyst 1,5936,1,4155,5168,1013,24.38%
Disability Analyst 1,5936,2,4356,5418,1062,24.38%
Disability Analyst 1,5936,3,4555,5666,1111,24.39%
Disability Analyst 1,5936,4,4776,5941,1165,24.39%
Disability Analyst 1,5936,5,5019,6243,1224,24.39%
Disability Analyst 1,5936,6,5256,6538,1282,24.39%
Disability Analyst 1,5936,7,5503,6845,1342,24.39%
Disability Analyst 1,5936,8,5771,7178,1407,24.38%
Disability Analyst 1,5936,9,6051,7189,1138,18.81%
Disability Analyst 1,5936,10,6350,7205,855,13.46%
Disability Analyst 2,5937,1,4555,5666,1111,24.39%
Disability Analyst 2,5937,1,4555,5666,1111,24.39%
Disability Analyst 2,5937,2,4776,5941,1165,24.39%
Disability Analyst 2,5937,2,4776,5941,1165,24.39%
Disability Analyst 2,5937,3,5019,6243,1224,24.39%
Disability Analyst 2,5937,3,5019,6243,1224,24.39%
Disability Analyst 2,5937,4,5256,6538,1282,24.39%
Disability Analyst 2,5937,4,5256,6538,1282,24.39%
Disability Analyst 2,5937,5,5503,6845,1342,24.39%
Disability Analyst 2,5937,5,5503,6845,1342,24.39%
Disability Analyst 2,5937,6,5771,7178,1407,24.38%
Disability Analyst 2,5937,6,5771,7178,1407,24.38%
Disability Analyst 2,5937,7,6051,7527,1476,24.39%
Disability Analyst 2,5937,7,6051,7527,1476,24.39%
Disability Analyst 2,5937,8,6350,7898,1548,24.38%
Disability Analyst 2,5937,8,6350,7898,1548,24.38%
Disability Analyst 2,5937,9,6664,7917,1253,18.80%
Disability Analyst 2,5937,9,6664,7917,1253,18.80%
Disability Analyst 2,5937,10,6982,7922,940,13.46%
Disability Analyst 2,5937,10,6982,7922,940,13.46%
District Veterinarian,6440,1,5503,6845,1342,24.39%
District Veterinarian,6440,2,5771,7178,1407,24.38%
District Veterinarian,6440,3,6051,7527,1476,24.39%
District Veterinarian,6440,4,6350,7898,1548,24.38%
District Veterinarian,6440,5,6664,8289,1625,24.38%
District Veterinarian,6440,6,6982,8685,1703,24.39%
District Veterinarian,6440,7,7327,9114,1787,24.39%
District Veterinarian,6440,8,7678,9550,1872,24.38%
District Veterinarian,6440,9,8057,9572,1515,18.80%
District Veterinarian,6440,10,8450,9588,1138,13.47%
DOJ Claims Examiner,5933,1,3964,4930,966,24.37%
DOJ Claims Examiner,5933,2,4155,5168,1013,24.38%
DOJ Claims Examiner,5933,3,4356,5418,1062,24.38%
DOJ Claims Examiner,5933,4,4555,5666,1111,24.39%
DOJ Claims Examiner,5933,5,4776,5941,1165,24.39%
DOJ Claims Examiner,5933,6,5019,6243,1224,24.39%
DOJ Claims Examiner,5933,7,5256,6538,1282,24.39%
DOJ Claims Examiner,5933,8,5503,6845,1342,24.39%
DOJ Claims Examiner,5933,9,5771,6856,1085,18.80%
DOJ Claims Examiner,5933,10,6051,6866,815,13.47%
Dormitory Counselor 1,6767,1,3095,3849,754,24.36%
Dormitory Counselor 1,6767,2,3218,4002,784,24.36%
Dormitory Counselor 1,6767,3,3335,4148,813,24.38%
Dormitory Counselor 1,6767,4,3483,4332,849,24.38%
Dormitory Counselor 1,6767,5,3629,4514,885,24.39%
Dormitory Counselor 1,6767,6,3790,4714,924,24.38%
Dormitory Counselor 1,6767,7,3964,4930,966,24.37%
Dormitory Counselor 1,6767,8,4155,5168,1013,24.38%
Dormitory Counselor 1,6767,9,4356,5175,819,18.80%
Dormitory Counselor 1,6767,10,4555,5168,613,13.46%
Dormitory Counselor 2,6768,1,3629,4514,885,24.39%
Dormitory Counselor 2,6768,2,3790,4714,924,24.38%
Dormitory Counselor 2,6768,3,3964,4930,966,24.37%
Dormitory Counselor 2,6768,4,4155,5168,1013,24.38%
Dormitory Counselor 2,6768,5,4356,5418,1062,24.38%
Dormitory Counselor 2,6768,6,4555,5666,1111,24.39%
Dormitory Counselor 2,6768,7,4776,5941,1165,24.39%
Dormitory Counselor 2,6768,8,5019,6243,1224,24.39%
Dormitory Counselor 2,6768,9,5256,6244,988,18.80%
Dormitory Counselor 2,6768,10,5503,6244,741,13.47%
Economist 1,1161,1,4155,5168,1013,24.38%
Economist 1,1161,2,4356,5418,1062,24.38%
Economist 1,1161,3,4555,5666,1111,24.39%
Economist 1,1161,4,4776,5941,1165,24.39%
Economist 1,1161,5,5019,6243,1224,24.39%
Economist 1,1161,6,5256,6538,1282,24.39%
Economist 1,1161,7,5503,6845,1342,24.39%
Economist 1,1161,8,5771,7178,1407,24.38%
Economist 1,1161,9,6051,7189,1138,18.81%
Economist 1,1161,10,6350,7205,855,13.46%
Economist 2,1163,1,5019,6243,1224,24.39%
Economist 2,1163,2,5256,6538,1282,24.39%
Economist 2,1163,3,5503,6845,1342,24.39%
Economist 2,1163,4,5771,7178,1407,24.38%
Economist 2,1163,5,6051,7527,1476,24.39%
Economist 2,1163,6,6350,7898,1548,24.38%
Economist 2,1163,7,6664,8289,1625,24.38%
Economist 2,1163,8,6982,8685,1703,24.39%
Economist 2,1163,9,7327,8705,1378,18.81%
Economist 2,1163,10,7678,8712,1034,13.47%
Economist 3,1163,1,5771,7178,1407,24.38%
Economist 3,1163,2,6051,7527,1476,24.39%
Economist 3,1163,3,6350,7898,1548,24.38%
Economist 3,1163,4,6664,8289,1625,24.38%
Economist 3,1163,5,6982,8685,1703,24.39%
Economist 3,1163,6,7327,9114,1787,24.39%
Economist 3,1163,7,7678,9550,1872,24.38%
Economist 3,1163,8,8057,10022,1965,24.39%
Economist 3,1163,9,8450,10039,1589,18.80%
Economist 3,1163,10,8870,10065,1195,13.47%
Economist 4,1164,1,6664,8289,1625,24.38%
Economist 4,1164,2,6982,8685,1703,24.39%
Economist 4,1164,3,7327,9114,1787,24.39%
Economist 4,1164,4,7678,9550,1872,24.38%
Economist 4,1164,5,8057,10022,1965,24.39%
Economist 4,1164,6,8450,10511,2061,24.39%
Economist 4,1164,7,8870,11033,2163,24.39%
Economist 4,1164,8,9293,11559,2266,24.38%
Economist 4,1164,9,9751,11585,1834,18.81%
Economist 4,1164,10,10242,11622,1380,13.47%
Education Program Specialist 1,3300,1,5771,7178,1407,24.38%
Education Program Specialist 1,3300,2,6051,7527,1476,24.39%
Education Program Specialist 1,3300,3,6350,7898,1548,24.38%
Education Program Specialist 1,3300,4,6664,8289,1625,24.38%
Education Program Specialist 1,3300,5,6982,8685,1703,24.39%
Education Program Specialist 1,3300,6,7327,9114,1787,24.39%
Education Program Specialist 1,3300,7,7678,9550,1872,24.38%
Education Program Specialist 1,3300,8,8057,10022,1965,24.39%
Education Program Specialist 1,3300,9,8450,10039,1589,18.80%
Education Program Specialist 1,3300,10,8870,10065,1195,13.47%
Education Program Specialist 2,3301,1,6664,8289,1625,24.38%
Education Program Specialist 2,3301,2,6982,8685,1703,24.39%
Education Program Specialist 2,3301,3,7327,9114,1787,24.39%
Education Program Specialist 2,3301,4,7678,9550,1872,24.38%
Education Program Specialist 2,3301,5,8057,10022,1965,24.39%
Education Program Specialist 2,3301,6,8450,10511,2061,24.39%
Education Program Specialist 2,3301,7,8870,11033,2163,24.39%
Education Program Specialist 2,3301,8,9293,11559,2266,24.38%
Education Program Specialist 2,3301,9,9751,11585,1834,18.81%
Education Program Specialist 2,3301,10,10242,11622,1380,13.47%
Electrician 2,4008,1,4776,5941,1165,24.39%
Electrician 2,4008,2,5019,6243,1224,24.39%
Electrician 2,4008,3,5256,6538,1282,24.39%
Electrician 2,4008,4,5503,6845,1342,24.39%
Electrician 2,4008,5,5771,7178,1407,24.38%
Electrician 2,4008,6,6051,7527,1476,24.39%
Electrician 2,4008,7,6350,7898,1548,24.38%
Electrician 2,4008,8,6664,8289,1625,24.38%
Electrician 2,4008,9,6982,8295,1313,18.81%
Electrician 2,4008,10,7327,8314,987,13.47%
Electrician 3,4009,1,5256,6538,1282,24.39%
Electrician 3,4009,2,5503,6845,1342,24.39%
Electrician 3,4009,3,5771,7178,1407,24.38%
Electrician 3,4009,4,6051,7527,1476,24.39%
Electrician 3,4009,5,6350,7898,1548,24.38%
Electrician 3,4009,6,6664,8289,1625,24.38%
Electrician 3,4009,7,6982,8685,1703,24.39%
Electrician 3,4009,8,7327,9114,1787,24.39%
Electrician 3,4009,9,7678,9122,1444,18.81%
Electrician 3,4009,10,8057,9142,1085,13.47%
Electronic Publishing Design Specialist 1,3510,1,3218,4002,784,24.36%
Electronic Publishing Design Specialist 1,3510,2,3335,4148,813,24.38%
Electronic Publishing Design Specialist 1,3510,3,3483,4332,849,24.38%
Electronic Publishing Design Specialist 1,3510,4,3629,4514,885,24.39%
Electronic Publishing Design Specialist 1,3510,5,3790,4714,924,24.38%
Electronic Publishing Design Specialist 1,3510,6,3964,4930,966,24.37%
Electronic Publishing Design Specialist 1,3510,7,4155,5168,1013,24.38%
Electronic Publishing Design Specialist 1,3510,8,4356,5418,1062,24.38%
Electronic Publishing Design Specialist 1,3510,9,4555,5411,856,18.79%
Electronic Publishing Design Specialist 1,3510,10,4776,5419,643,13.46%
Electronic Publishing Design Specialist 2,3511,1,3964,4930,966,24.37%
Electronic Publishing Design Specialist 2,3511,2,4155,5168,1013,24.38%
Electronic Publishing Design Specialist 2,3511,3,4356,5418,1062,24.38%
Electronic Publishing Design Specialist 2,3511,4,4555,5666,1111,24.39%
Electronic Publishing Design Specialist 2,3511,5,4776,5941,1165,24.39%
Electronic Publishing Design Specialist 2,3511,6,5019,6243,1224,24.39%
Electronic Publishing Design Specialist 2,3511,7,5256,6538,1282,24.39%
Electronic Publishing Design Specialist 2,3511,8,5503,6845,1342,24.39%
Electronic Publishing Design Specialist 2,3511,9,5771,6856,1085,18.80%
Electronic Publishing Design Specialist 2,3511,10,6051,6866,815,13.47%
Electronic Publishing Design Specialist 3,3513,1,4356,5418,1062,24.38%
Electronic Publishing Design Specialist 3,3513,2,4555,5666,1111,24.39%
Electronic Publishing Design Specialist 3,3513,3,4776,5941,1165,24.39%
Electronic Publishing Design Specialist 3,3513,4,5019,6243,1224,24.39%
Electronic Publishing Design Specialist 3,3513,5,5256,6538,1282,24.39%
Electronic Publishing Design Specialist 3,3513,6,5503,6845,1342,24.39%
Electronic Publishing Design Specialist 3,3513,7,5771,7178,1407,24.38%
Electronic Publishing Design Specialist 3,3513,8,6051,7527,1476,24.39%
Electronic Publishing Design Specialist 3,3513,9,6350,7544,1194,18.80%
Electronic Publishing Design Specialist 3,3513,10,6664,7562,898,13.48%
Electronic Security Technician 2,4051,1,4776,5941,1165,24.39%
Electronic Security Technician 2,4051,2,5019,6243,1224,24.39%
Electronic Security Technician 2,4051,3,5256,6538,1282,24.39%
Electronic Security Technician 2,4051,4,5503,6845,1342,24.39%
Electronic Security Technician 2,4051,5,5771,7178,1407,24.38%
Electronic Security Technician 2,4051,6,6051,7527,1476,24.39%
Electronic Security Technician 2,4051,7,6350,7898,1548,24.38%
Electronic Security Technician 2,4051,8,6664,8289,1625,24.38%
Electronic Security Technician 2,4051,9,6982,8295,1313,18.81%
Electronic Security Technician 2,4051,10,7327,8314,987,13.47%
Employment Adjudicator,6693,1,4155,5168,1013,24.38%
Employment Adjudicator,6693,2,4356,5418,1062,24.38%
Employment Adjudicator,6693,3,4555,5666,1111,24.39%
Employment Adjudicator,6693,4,4776,5941,1165,24.39%
Employment Adjudicator,6693,5,5019,6243,1224,24.39%
Employment Adjudicator,6693,6,5256,6538,1282,24.39%
Employment Adjudicator,6693,7,5503,6845,1342,24.39%
Employment Adjudicator,6693,8,5771,7178,1407,24.38%
Employment Adjudicator,6693,9,6051,7189,1138,18.81%
Employment Adjudicator,6693,10,6350,7205,855,13.46%
Employment Appeals Board Legal Staff,1543,1,5503,6845,1342,24.39%
Employment Appeals Board Legal Staff,1543,2,5771,7178,1407,24.38%
Employment Appeals Board Legal Staff,1543,3,6051,7527,1476,24.39%
Employment Appeals Board Legal Staff,1543,4,6350,7898,1548,24.38%
Employment Appeals Board Legal Staff,1543,5,6664,8289,1625,24.38%
Employment Appeals Board Legal Staff,1543,6,6982,8685,1703,24.39%
Employment Appeals Board Legal Staff,1543,7,7327,9114,1787,24.39%
Employment Appeals Board Legal Staff,1543,8,7678,9550,1872,24.38%
Employment Appeals Board Legal Staff,1543,9,8057,9572,1515,18.80%
Employment Appeals Board Legal Staff,1543,10,8450,9588,1138,13.47%
Engineering Technician 2,3110,1,3483,4332,849,24.38%
Engineering Technician 2,3110,2,3629,4514,885,24.39%
Engineering Technician 2,3110,3,3790,4714,924,24.38%
Engineering Technician 2,3110,4,3964,4930,966,24.37%
Engineering Technician 2,3110,5,4155,5168,1013,24.38%
Engineering Technician 2,3110,6,4356,5418,1062,24.38%
Engineering Technician 2,3110,7,4555,5666,1111,24.39%
Engineering Technician 2,3110,8,4776,5941,1165,24.39%
Engineering Technician 2,3110,9,5019,5963,944,18.81%
Engineering Technician 2,3110,10,5256,5964,708,13.47%
Engineering Technician 3,3111,1,3790,4714,924,24.38%
Engineering Technician 3,3111,2,3964,4930,966,24.37%
Engineering Technician 3,3111,3,4155,5168,1013,24.38%
Engineering Technician 3,3111,4,4356,5418,1062,24.38%
Engineering Technician 3,3111,5,4555,5666,1111,24.39%
Engineering Technician 3,3111,6,4776,5941,1165,24.39%
Engineering Technician 3,3111,7,5019,6243,1224,24.39%
Engineering Technician 3,3111,8,5256,6538,1282,24.39%
Engineering Technician 3,3111,9,5503,6538,1035,18.81%
Engineering Technician 3,3111,10,5771,6548,777,13.46%
Environmental Engineer 2,3411,1,5771,7178,1407,24.38%
Environmental Engineer 2,3411,2,6051,7527,1476,24.39%
Environmental Engineer 2,3411,3,6350,7898,1548,24.38%
Environmental Engineer 2,3411,4,6664,8289,1625,24.38%
Environmental Engineer 2,3411,5,6982,8685,1703,24.39%
Environmental Engineer 2,3411,6,7327,9114,1787,24.39%
Environmental Engineer 2,3411,7,7678,9550,1872,24.38%
Environmental Engineer 2,3411,8,8057,10022,1965,24.39%
Environmental Engineer 2,3411,9,8450,10039,1589,18.80%
Environmental Engineer 2,3411,10,8870,10065,1195,13.47%
Environmental Engineer 3,3413,1,6664,8289,1625,24.38%
Environmental Engineer 3,3413,2,6982,8685,1703,24.39%
Environmental Engineer 3,3413,3,7327,9114,1787,24.39%
Environmental Engineer 3,3413,4,7678,9550,1872,24.38%
Environmental Engineer 3,3413,5,8057,10022,1965,24.39%
Environmental Engineer 3,3413,6,8450,10511,2061,24.39%
Environmental Engineer 3,3413,7,8870,11033,2163,24.39%
Environmental Engineer 3,3413,8,9293,11559,2266,24.38%
Environmental Engineer 3,3413,9,9751,11585,1834,18.81%
Environmental Engineer 3,3413,10,10242,11622,1380,13.47%
Environmental Health Specialist 3,3819,1,5256,6538,1282,24.39%
Environmental Health Specialist 3,3819,2,5503,6845,1342,24.39%
Environmental Health Specialist 3,3819,3,5771,7178,1407,24.38%
Environmental Health Specialist 3,3819,4,6051,7527,1476,24.39%
Environmental Health Specialist 3,3819,5,6350,7898,1548,24.38%
Environmental Health Specialist 3,3819,6,6664,8289,1625,24.38%
Environmental Health Specialist 3,3819,7,6982,8685,1703,24.39%
Environmental Health Specialist 3,3819,8,7327,9114,1787,24.39%
Environmental Health Specialist 3,3819,9,7678,9122,1444,18.81%
Environmental Health Specialist 3,3819,10,8057,9142,1085,13.47%
Epidemiologist 1,6316,1,5019,6243,1224,24.39%
Epidemiologist 1,6316,2,5256,6538,1282,24.39%
Epidemiologist 1,6316,3,5503,6845,1342,24.39%
Epidemiologist 1,6316,4,5771,7178,1407,24.38%
Epidemiologist 1,6316,5,6051,7527,1476,24.39%
Epidemiologist 1,6316,6,6350,7898,1548,24.38%
Epidemiologist 1,6316,7,6664,8289,1625,24.38%
Epidemiologist 1,6316,8,6982,8685,1703,24.39%
Epidemiologist 1,6316,9,7327,8705,1378,18.81%
Epidemiologist 1,6316,10,7678,8712,1034,13.47%
Epidemiologist 2,6317,1,5771,7178,1407,24.38%
Epidemiologist 2,6317,2,6051,7527,1476,24.39%
Epidemiologist 2,6317,3,6350,7898,1548,24.38%
Epidemiologist 2,6317,4,6664,8289,1625,24.38%
Epidemiologist 2,6317,5,6982,8685,1703,24.39%
Epidemiologist 2,6317,6,7327,9114,1787,24.39%
Epidemiologist 2,6317,7,7678,9550,1872,24.38%
Epidemiologist 2,6317,8,8057,10022,1965,24.39%
Epidemiologist 2,6317,9,8450,10039,1589,18.80%
Epidemiologist 2,6317,10,8870,10065,1195,13.47%
Epidemiologist 3,6318,1,6350,7898,1548,24.38%
Epidemiologist 3,6318,2,6664,8289,1625,24.38%
Epidemiologist 3,6318,3,6982,8685,1703,24.39%
Epidemiologist 3,6318,4,7327,9114,1787,24.39%
Epidemiologist 3,6318,5,7678,9550,1872,24.38%
Epidemiologist 3,6318,6,8057,10022,1965,24.39%
Epidemiologist 3,6318,7,8450,10511,2061,24.39%
Epidemiologist 3,6318,8,8870,11033,2163,24.39%
Epidemiologist 3,6318,9,9293,11040,1747,18.80%
Epidemiologist 3,6318,10,9751,11065,1314,13.48%
Equipment Operator,4433,1,3790,4714,924,24.38%
Equipment Operator,4433,2,3964,4930,966,24.37%
Equipment Operator,4433,3,4155,5168,1013,24.38%
Equipment Operator,4433,4,4356,5418,1062,24.38%
Equipment Operator,4433,5,4555,5666,1111,24.39%
Equipment Operator,4433,6,4776,5941,1165,24.39%
Equipment Operator,4433,7,5019,6243,1224,24.39%
Equipment Operator,4433,8,5256,6538,1282,24.39%
Equipment Operator,4433,9,5503,6538,1035,18.81%
Equipment Operator,4433,10,5771,6548,777,13.46%
Executive Assistant,830,1,4555,5666,1111,24.39%
Executive Assistant,830,2,4776,5941,1165,24.39%
Executive Assistant,830,3,5019,6243,1224,24.39%
Executive Assistant,830,4,5256,6538,1282,24.39%
Executive Assistant,830,5,5503,6845,1342,24.39%
Executive Assistant,830,6,5771,7178,1407,24.38%
Executive Assistant,830,7,6051,7527,1476,24.39%
Executive Assistant,830,8,6350,7898,1548,24.38%
Executive Assistant,830,9,6664,7917,1253,18.80%
Executive Assistant,830,10,6982,7922,940,13.46%
Executive Support Specialist 1,118,1,3218,4002,784,24.36%
Executive Support Specialist 1,118,2,3335,4148,813,24.38%
Executive Support Specialist 1,118,3,3483,4332,849,24.38%
Executive Support Specialist 1,118,4,3629,4514,885,24.39%
Executive Support Specialist 1,118,5,3790,4714,924,24.38%
Executive Support Specialist 1,118,6,3964,4930,966,24.37%
Executive Support Specialist 1,118,7,4155,5168,1013,24.38%
Executive Support Specialist 1,118,8,4356,5418,1062,24.38%
Executive Support Specialist 1,118,9,4555,5411,856,18.79%
Executive Support Specialist 1,118,10,4776,5419,643,13.46%
Executive Support Specialist 2,119,1,3629,4514,885,24.39%
Executive Support Specialist 2,119,2,3790,4714,924,24.38%
Executive Support Specialist 2,119,3,3964,4930,966,24.37%
Executive Support Specialist 2,119,4,4155,5168,1013,24.38%
Executive Support Specialist 2,119,5,4356,5418,1062,24.38%
Executive Support Specialist 2,119,6,4555,5666,1111,24.39%
Executive Support Specialist 2,119,7,4776,5941,1165,24.39%
Executive Support Specialist 2,119,8,5019,6243,1224,24.39%
Executive Support Specialist 2,119,9,5256,6244,988,18.80%
Executive Support Specialist 2,119,10,5503,6244,741,13.47%
Facilities Engineer 1,3351,1,5019,6243,1224,24.39%
Facilities Engineer 1,3351,2,5256,6538,1282,24.39%
Facilities Engineer 1,3351,3,5503,6845,1342,24.39%
Facilities Engineer 1,3351,4,5771,7178,1407,24.38%
Facilities Engineer 1,3351,5,6051,7527,1476,24.39%
Facilities Engineer 1,3351,6,6350,7898,1548,24.38%
Facilities Engineer 1,3351,7,6664,8289,1625,24.38%
Facilities Engineer 1,3351,8,6982,8685,1703,24.39%
Facilities Engineer 1,3351,9,7327,8705,1378,18.81%
Facilities Engineer 1,3351,10,7678,8712,1034,13.47%
Facilities Engineer 3,3353,1,6664,8289,1625,24.38%
Facilities Engineer 3,3353,2,6982,8685,1703,24.39%
Facilities Engineer 3,3353,3,7327,9114,1787,24.39%
Facilities Engineer 3,3353,4,7678,9550,1872,24.38%
Facilities Engineer 3,3353,5,8057,10022,1965,24.39%
Facilities Engineer 3,3353,6,8450,10511,2061,24.39%
Facilities Engineer 3,3353,7,8870,11033,2163,24.39%
Facilities Engineer 3,3353,8,9293,11559,2266,24.38%
Facilities Engineer 3,3353,9,9751,11585,1834,18.81%
Facilities Engineer 3,3353,10,10242,11622,1380,13.47%
Facility Energy Technician 2,4033,1,3964,4930,966,24.37%
Facility Energy Technician 2,4033,2,4155,5168,1013,24.38%
Facility Energy Technician 2,4033,3,4356,5418,1062,24.38%
Facility Energy Technician 2,4033,4,4555,5666,1111,24.39%
Facility Energy Technician 2,4033,5,4776,5941,1165,24.39%
Facility Energy Technician 2,4033,6,5019,6243,1224,24.39%
Facility Energy Technician 2,4033,7,5256,6538,1282,24.39%
Facility Energy Technician 2,4033,8,5503,6845,1342,24.39%
Facility Energy Technician 2,4033,9,5771,6856,1085,18.80%
Facility Energy Technician 2,4033,10,6051,6866,815,13.47%
Facility Energy Technician 3,4034,1,4776,5941,1165,24.39%
Facility Energy Technician 3,4034,2,5019,6243,1224,24.39%
Facility Energy Technician 3,4034,3,5256,6538,1282,24.39%
Facility Energy Technician 3,4034,4,5503,6845,1342,24.39%
Facility Energy Technician 3,4034,5,5771,7178,1407,24.38%
Facility Energy Technician 3,4034,6,6051,7527,1476,24.39%
Facility Energy Technician 3,4034,7,6350,7898,1548,24.38%
Facility Energy Technician 3,4034,8,6664,8289,1625,24.38%
Facility Energy Technician 3,4034,9,6982,8295,1313,18.81%
Facility Energy Technician 3,4034,10,7327,8314,987,13.47%
Facility Energy Technician 4,4035,1,5503,6845,1342,24.39%
Facility Energy Technician 4,4035,2,5771,7178,1407,24.38%
Facility Energy Technician 4,4035,3,6051,7527,1476,24.39%
Facility Energy Technician 4,4035,4,6350,7898,1548,24.38%
Facility Energy Technician 4,4035,5,6664,8289,1625,24.38%
Facility Energy Technician 4,4035,6,6982,8685,1703,24.39%
Facility Energy Technician 4,4035,7,7327,9114,1787,24.39%
Facility Energy Technician 4,4035,8,7678,9550,1872,24.38%
Facility Energy Technician 4,4035,9,8057,9572,1515,18.80%
Facility Energy Technician 4,4035,10,8450,9588,1138,13.47%
Facility Maintenance Specialist,4013,1,3335,4148,813,24.38%
Facility Maintenance Specialist,4013,2,3483,4332,849,24.38%
Facility Maintenance Specialist,4013,3,3629,4514,885,24.39%
Facility Maintenance Specialist,4013,4,3790,4714,924,24.38%
Facility Maintenance Specialist,4013,5,3964,4930,966,24.37%
Facility Maintenance Specialist,4013,6,4155,5168,1013,24.38%
Facility Maintenance Specialist,4013,7,4356,5418,1062,24.38%
Facility Maintenance Specialist,4013,8,4555,5666,1111,24.39%
Facility Maintenance Specialist,4013,9,4776,5674,898,18.80%
Facility Maintenance Specialist,4013,10,5019,5695,676,13.47%
Facility Operations Specialist 1,4014,1,4356,5418,1062,24.38%
Facility Operations Specialist 1,4014,2,4555,5666,1111,24.39%
Facility Operations Specialist 1,4014,3,4776,5941,1165,24.39%
Facility Operations Specialist 1,4014,4,5019,6243,1224,24.39%
Facility Operations Specialist 1,4014,5,5256,6538,1282,24.39%
Facility Operations Specialist 1,4014,6,5503,6845,1342,24.39%
Facility Operations Specialist 1,4014,7,5771,7178,1407,24.38%
Facility Operations Specialist 1,4014,8,6051,7527,1476,24.39%
Facility Operations Specialist 1,4014,9,6350,7544,1194,18.80%
Facility Operations Specialist 1,4014,10,6664,7562,898,13.48%
Facility Operations Specialist 2,4015,1,4776,5941,1165,24.39%
Facility Operations Specialist 2,4015,2,5019,6243,1224,24.39%
Facility Operations Specialist 2,4015,3,5256,6538,1282,24.39%
Facility Operations Specialist 2,4015,4,5503,6845,1342,24.39%
Facility Operations Specialist 2,4015,5,5771,7178,1407,24.38%
Facility Operations Specialist 2,4015,6,6051,7527,1476,24.39%
Facility Operations Specialist 2,4015,7,6350,7898,1548,24.38%
Facility Operations Specialist 2,4015,8,6664,8289,1625,24.38%
Facility Operations Specialist 2,4015,9,6982,8295,1313,18.81%
Facility Operations Specialist 2,4015,10,7327,8314,987,13.47%
Financial Enforcement Officer,1547,1,6350,7898,1548,24.38%
Financial Enforcement Officer,1547,2,6664,8289,1625,24.38%
Financial Enforcement Officer,1547,3,6982,8685,1703,24.39%
Financial Enforcement Officer,1547,4,7327,9114,1787,24.39%
Financial Enforcement Officer,1547,5,7678,9550,1872,24.38%
Financial Enforcement Officer,1547,6,8057,10022,1965,24.39%
Financial Enforcement Officer,1547,7,8450,10511,2061,24.39%
Financial Enforcement Officer,1547,8,8870,11033,2163,24.39%
Financial Enforcement Officer,1547,9,9293,11040,1747,18.80%
Financial Enforcement Officer,1547,10,9751,11065,1314,13.48%
Financial Examiner 1,5675,1,4356,5418,1062,24.38%
Financial Examiner 1,5675,2,4555,5666,1111,24.39%
Financial Examiner 1,5675,3,4776,5941,1165,24.39%
Financial Examiner 1,5675,4,5019,6243,1224,24.39%
Financial Examiner 1,5675,5,5256,6538,1282,24.39%
Financial Examiner 1,5675,6,5503,6845,1342,24.39%
Financial Examiner 1,5675,7,5771,7178,1407,24.38%
Financial Examiner 1,5675,8,6051,7527,1476,24.39%
Financial Examiner 1,5675,9,6350,7544,1194,18.80%
Financial Examiner 1,5675,10,6664,7562,898,13.48%
Financial Examiner 2,5676,1,5019,6243,1224,24.39%
Financial Examiner 2,5676,2,5256,6538,1282,24.39%
Financial Examiner 2,5676,3,5503,6845,1342,24.39%
Financial Examiner 2,5676,4,5771,7178,1407,24.38%
Financial Examiner 2,5676,5,6051,7527,1476,24.39%
Financial Examiner 2,5676,6,6350,7898,1548,24.38%
Financial Examiner 2,5676,7,6664,8289,1625,24.38%
Financial Examiner 2,5676,8,6982,8685,1703,24.39%
Financial Examiner 2,5676,9,7327,8705,1378,18.81%
Financial Examiner 2,5676,10,7678,8712,1034,13.47%
Financial Examiner 3,5677,1,5771,7178,1407,24.38%
Financial Examiner 3,5677,2,6051,7527,1476,24.39%
Financial Examiner 3,5677,3,6350,7898,1548,24.38%
Financial Examiner 3,5677,4,6664,8289,1625,24.38%
Financial Examiner 3,5677,5,6982,8685,1703,24.39%
Financial Examiner 3,5677,6,7327,9114,1787,24.39%
Financial Examiner 3,5677,7,7678,9550,1872,24.38%
Financial Examiner 3,5677,8,8057,10022,1965,24.39%
Financial Examiner 3,5677,9,8450,10039,1589,18.80%
Financial Examiner 3,5677,10,8870,10065,1195,13.47%
Financial Investigator 1,5335,1,4776,5941,1165,24.39%
Financial Investigator 1,5335,2,5019,6243,1224,24.39%
Financial Investigator 1,5335,3,5256,6538,1282,24.39%
Financial Investigator 1,5335,4,5503,6845,1342,24.39%
Financial Investigator 1,5335,5,5771,7178,1407,24.38%
Financial Investigator 1,5335,6,6051,7527,1476,24.39%
Financial Investigator 1,5335,7,6350,7898,1548,24.38%
Financial Investigator 1,5335,8,6664,8289,1625,24.38%
Financial Investigator 1,5335,9,6982,8295,1313,18.81%
Financial Investigator 1,5335,10,7327,8314,987,13.47%
Fiscal Analyst 1,1343,1,4155,5168,1013,24.38%
Fiscal Analyst 1,1343,2,4356,5418,1062,24.38%
Fiscal Analyst 1,1343,3,4555,5666,1111,24.39%
Fiscal Analyst 1,1343,4,4776,5941,1165,24.39%
Fiscal Analyst 1,1343,5,5019,6243,1224,24.39%
Fiscal Analyst 1,1343,6,5256,6538,1282,24.39%
Fiscal Analyst 1,1343,7,5503,6845,1342,24.39%
Fiscal Analyst 1,1343,8,5771,7178,1407,24.38%
Fiscal Analyst 1,1343,9,6051,7189,1138,18.81%
Fiscal Analyst 1,1343,10,6350,7205,855,13.46%
Fiscal Analyst 2,1344,1,5019,6243,1224,24.39%
Fiscal Analyst 2,1344,2,5256,6538,1282,24.39%
Fiscal Analyst 2,1344,3,5503,6845,1342,24.39%
Fiscal Analyst 2,1344,4,5771,7178,1407,24.38%
Fiscal Analyst 2,1344,5,6051,7527,1476,24.39%
Fiscal Analyst 2,1344,6,6350,7898,1548,24.38%
Fiscal Analyst 2,1344,7,6664,8289,1625,24.38%
Fiscal Analyst 2,1344,8,6982,8685,1703,24.39%
Fiscal Analyst 2,1344,9,7327,8705,1378,18.81%
Fiscal Analyst 2,1344,10,7678,8712,1034,13.47%
Fiscal Analyst 3,1345,1,5771,7178,1407,24.38%
Fiscal Analyst 3,1345,2,6051,7527,1476,24.39%
Fiscal Analyst 3,1345,3,6350,7898,1548,24.38%
Fiscal Analyst 3,1345,4,6664,8289,1625,24.38%
Fiscal Analyst 3,1345,5,6982,8685,1703,24.39%
Fiscal Analyst 3,1345,6,7327,9114,1787,24.39%
Fiscal Analyst 3,1345,7,7678,9550,1872,24.38%
Fiscal Analyst 3,1345,8,8057,10022,1965,24.39%
Fiscal Analyst 3,1345,9,8450,10039,1589,18.80%
Fiscal Analyst 3,1345,10,8870,10065,1195,13.47%
Fiscal Auditor 1,5641,1,4155,5168,1013,24.38%
Fiscal Auditor 1,5641,2,4356,5418,1062,24.38%
Fiscal Auditor 1,5641,3,4555,5666,1111,24.39%
Fiscal Auditor 1,5641,4,4776,5941,1165,24.39%
Fiscal Auditor 1,5641,5,5019,6243,1224,24.39%
Fiscal Auditor 1,5641,6,5256,6538,1282,24.39%
Fiscal Auditor 1,5641,7,5503,6845,1342,24.39%
Fiscal Auditor 1,5641,8,5771,7178,1407,24.38%
Fiscal Auditor 1,5641,9,6051,7189,1138,18.81%
Fiscal Auditor 1,5641,10,6350,7205,855,13.46%
Fish and Wildlife Technical Coordinator,8346,1,3790,4714,924,24.38%
Fish and Wildlife Technical Coordinator,8346,2,3964,4930,966,24.37%
Fish and Wildlife Technical Coordinator,8346,3,4155,5168,1013,24.38%
Fish and Wildlife Technical Coordinator,8346,4,4356,5418,1062,24.38%
Fish and Wildlife Technical Coordinator,8346,5,4555,5666,1111,24.39%
Fish and Wildlife Technical Coordinator,8346,6,4776,5941,1165,24.39%
Fish and Wildlife Technical Coordinator,8346,7,5019,6243,1224,24.39%
Fish and Wildlife Technical Coordinator,8346,8,5256,6538,1282,24.39%
Fish and Wildlife Technical Coordinator,8346,9,5503,6538,1035,18.81%
Fish and Wildlife Technical Coordinator,8346,10,5771,6548,777,13.46%
Fish and Wildlife Technician,8341,1,3218,4002,784,24.36%
Fish and Wildlife Technician,8341,1,3218,4002,784,24.36%
Fish and Wildlife Technician,8341,2,3335,4148,813,24.38%
Fish and Wildlife Technician,8341,2,3335,4148,813,24.38%
Fish and Wildlife Technician,8341,3,3483,4332,849,24.38%
Fish and Wildlife Technician,8341,3,3483,4332,849,24.38%
Fish and Wildlife Technician,8341,4,3629,4514,885,24.39%
Fish and Wildlife Technician,8341,4,3629,4514,885,24.39%
Fish and Wildlife Technician,8341,5,3790,4714,924,24.38%
Fish and Wildlife Technician,8341,5,3790,4714,924,24.38%
Fish and Wildlife Technician,8341,6,3964,4930,966,24.37%
Fish and Wildlife Technician,8341,6,3964,4930,966,24.37%
Fish and Wildlife Technician,8341,7,4155,5168,1013,24.38%
Fish and Wildlife Technician,8341,7,4155,5168,1013,24.38%
Fish and Wildlife Technician,8341,8,4356,5418,1062,24.38%
Fish and Wildlife Technician,8341,8,4356,5418,1062,24.38%
Fish and Wildlife Technician,8341,9,4555,5411,856,18.79%
Fish and Wildlife Technician,8341,9,4555,5411,856,18.79%
Fish and Wildlife Technician,8341,10,4776,5419,643,13.46%
Fish and Wildlife Technician,8341,10,4776,5419,643,13.46%
Fish and Wildlife Technician Entry,8340,1,0,0,0,
Fish and Wildlife Technician Entry,8340,2,0,0,0,
Fish and Wildlife Technician Entry,8340,3,3005,3738,733,24.39%
Fish and Wildlife Technician Entry,8340,4,3095,3849,754,24.36%
Fish and Wildlife Technician Entry,8340,5,3218,4002,784,24.36%
Fish and Wildlife Technician Entry,8340,6,3335,4148,813,24.38%
Fish and Wildlife Technician Entry,8340,7,3483,4332,849,24.38%
Fish and Wildlife Technician Entry,8340,8,3629,4514,885,24.39%
Fish and Wildlife Technician Entry,8340,9,3790,4502,712,18.79%
Fish and Wildlife Technician Entry,8340,10,3964,4498,534,13.47%
Fish and Wildlife Technician Senior,8343,1,3483,4332,849,24.38%
Fish and Wildlife Technician Senior,8343,2,3629,4514,885,24.39%
Fish and Wildlife Technician Senior,8343,3,3790,4714,924,24.38%
Fish and Wildlife Technician Senior,8343,4,3964,4930,966,24.37%
Fish and Wildlife Technician Senior,8343,5,4155,5168,1013,24.38%
Fish and Wildlife Technician Senior,8343,6,4356,5418,1062,24.38%
Fish and Wildlife Technician Senior,8343,7,4555,5666,1111,24.39%
Fish and Wildlife Technician Senior,8343,8,4776,5941,1165,24.39%
Fish and Wildlife Technician Senior,8343,9,5019,5963,944,18.81%
Fish and Wildlife Technician Senior,8343,10,5256,5964,708,13.47%
Food Service Worker,9103,1,0,0,0,
Food Service Worker,9103,1,0,0,0,
Food Service Worker,9103,2,0,0,0,
Food Service Worker,9103,2,0,0,0,
Food Service Worker,9103,3,3005,3913,908,30.22%
Food Service Worker,9103,3,3005,3913,908,30.22%
Food Service Worker,9103,4,3095,3849,754,24.36%
Food Service Worker,9103,4,3095,3849,754,24.36%
Food Service Worker,9103,5,3218,4002,784,24.36%
Food Service Worker,9103,5,3218,4002,784,24.36%
Food Service Worker,9103,6,3335,4148,813,24.38%
Food Service Worker,9103,6,3335,4148,813,24.38%
Food Service Worker,9103,7,3483,4332,849,24.38%
Food Service Worker,9103,7,3483,4332,849,24.38%
Food Service Worker,9103,8,3629,4514,885,24.39%
Food Service Worker,9103,8,3629,4514,885,24.39%
Food Service Worker,9103,9,3790,4502,712,18.79%
Food Service Worker,9103,9,3790,4502,712,18.79%
Food Service Worker,9103,10,3964,4498,534,13.47%
Food Service Worker,9103,10,3964,4498,534,13.47%
Forest Crew Coordinator,8318,1,3483,4332,849,24.38%
Forest Crew Coordinator,8318,2,3629,4514,885,24.39%
Forest Crew Coordinator,8318,3,3790,4714,924,24.38%
Forest Crew Coordinator,8318,4,3964,4930,966,24.37%
Forest Crew Coordinator,8318,5,4155,5168,1013,24.38%
Forest Crew Coordinator,8318,6,4356,5418,1062,24.38%
Forest Crew Coordinator,8318,7,4555,5666,1111,24.39%
Forest Crew Coordinator,8318,8,4776,5941,1165,24.39%
Forest Crew Coordinator,8318,9,5019,5963,944,18.81%
Forest Crew Coordinator,8318,10,5256,5964,708,13.47%
Forest Lookout,8353,1,0,0,0,
Forest Lookout,8353,2,0,0,0,
Forest Lookout,8353,3,0,0,0,
Forest Lookout,8353,4,0,0,0,
Forest Lookout,8353,5,3005,3738,733,24.39%
Forest Lookout,8353,6,3095,3849,754,24.36%
Forest Lookout,8353,7,3218,4002,784,24.36%
Forest Lookout,8353,8,3335,4148,813,24.38%
Forest Lookout,8353,9,3483,4138,655,18.81%
Forest Lookout,8353,10,3629,4118,489,13.47%
Forest Management Technician,8311,1,3095,3849,754,24.36%
Forest Management Technician,8311,2,3218,4002,784,24.36%
Forest Management Technician,8311,3,3335,4148,813,24.38%
Forest Management Technician,8311,4,3483,4332,849,24.38%
Forest Management Technician,8311,5,3629,4514,885,24.39%
Forest Management Technician,8311,6,3790,4714,924,24.38%
Forest Management Technician,8311,7,3964,4930,966,24.37%
Forest Management Technician,8311,8,4155,5168,1013,24.38%
Forest Management Technician,8311,9,4356,5175,819,18.80%
Forest Management Technician,8311,10,4555,5168,613,13.46%
Forest Officer,8357,1,4155,5168,1013,24.38%
Forest Officer,8357,2,4356,5418,1062,24.38%
Forest Officer,8357,3,4555,5666,1111,24.39%
Forest Officer,8357,4,4776,5941,1165,24.39%
Forest Officer,8357,5,5019,6243,1224,24.39%
Forest Officer,8357,6,5256,6538,1282,24.39%
Forest Officer,8357,7,5503,6845,1342,24.39%
Forest Officer,8357,8,5771,7178,1407,24.38%
Forest Officer,8357,9,6051,7189,1138,18.81%
Forest Officer,8357,10,6350,7205,855,13.46%
Geologist 2,3531,1,4776,5941,1165,24.39%
Geologist 2,3531,2,5019,6243,1224,24.39%
Geologist 2,3531,3,5256,6538,1282,24.39%
Geologist 2,3531,4,5503,6845,1342,24.39%
Geologist 2,3531,5,5771,7178,1407,24.38%
Geologist 2,3531,6,6051,7527,1476,24.39%
Geologist 2,3531,7,6350,7898,1548,24.38%
Geologist 2,3531,8,6664,8289,1625,24.38%
Geologist 2,3531,9,6982,8295,1313,18.81%
Geologist 2,3531,10,7327,8314,987,13.47%
Governmental Auditor 1,5646,1,4356,5418,1062,24.38%
Governmental Auditor 1,5646,2,4555,5666,1111,24.39%
Governmental Auditor 1,5646,3,4776,5941,1165,24.39%
Governmental Auditor 1,5646,4,5019,6243,1224,24.39%
Governmental Auditor 1,5646,5,5256,6538,1282,24.39%
Governmental Auditor 1,5646,6,5503,6845,1342,24.39%
Governmental Auditor 1,5646,7,5771,7178,1407,24.38%
Governmental Auditor 1,5646,8,6051,7527,1476,24.39%
Governmental Auditor 1,5646,9,6350,7544,1194,18.80%
Governmental Auditor 1,5646,10,6664,7562,898,13.48%
Governmental Auditor 2,5647,1,4776,5941,1165,24.39%
Governmental Auditor 2,5647,2,5019,6243,1224,24.39%
Governmental Auditor 2,5647,3,5256,6538,1282,24.39%
Governmental Auditor 2,5647,4,5503,6845,1342,24.39%
Governmental Auditor 2,5647,5,5771,7178,1407,24.38%
Governmental Auditor 2,5647,6,6051,7527,1476,24.39%
Governmental Auditor 2,5647,7,6350,7898,1548,24.38%
Governmental Auditor 2,5647,8,6664,8289,1625,24.38%
Governmental Auditor 2,5647,9,6982,8295,1313,18.81%
Governmental Auditor 2,5647,10,7327,8314,987,13.47%
Governmental Auditor 3,5648,1,5503,6845,1342,24.39%
Governmental Auditor 3,5648,2,5771,7178,1407,24.38%
Governmental Auditor 3,5648,3,6051,7527,1476,24.39%
Governmental Auditor 3,5648,4,6350,7898,1548,24.38%
Governmental Auditor 3,5648,5,6664,8289,1625,24.38%
Governmental Auditor 3,5648,6,6982,8685,1703,24.39%
Governmental Auditor 3,5648,7,7327,9114,1787,24.39%
Governmental Auditor 3,5648,8,7678,9550,1872,24.38%
Governmental Auditor 3,5648,9,8057,9572,1515,18.80%
Governmental Auditor 3,5648,10,8450,9588,1138,13.47%
Grounds Maintenance Worker 1,4109,1,0,0,0,
Grounds Maintenance Worker 1,4109,2,3005,3738,733,24.39%
Grounds Maintenance Worker 1,4109,3,3095,3849,754,24.36%
Grounds Maintenance Worker 1,4109,4,3218,4002,784,24.36%
Grounds Maintenance Worker 1,4109,5,3335,4148,813,24.38%
Grounds Maintenance Worker 1,4109,6,3483,4332,849,24.38%
Grounds Maintenance Worker 1,4109,7,3629,4514,885,24.39%
Grounds Maintenance Worker 1,4109,8,3790,4714,924,24.38%
Grounds Maintenance Worker 1,4109,9,3964,4709,745,18.79%
Grounds Maintenance Worker 1,4109,10,4155,4714,559,13.45%
Grounds Maintenance Worker 2,4110,1,3218,4002,784,24.36%
Grounds Maintenance Worker 2,4110,1,3218,4002,784,24.36%
Grounds Maintenance Worker 2,4110,2,3335,4148,813,24.38%
Grounds Maintenance Worker 2,4110,2,3335,4148,813,24.38%
Grounds Maintenance Worker 2,4110,3,3483,4332,849,24.38%
Grounds Maintenance Worker 2,4110,3,3483,4332,849,24.38%
Grounds Maintenance Worker 2,4110,4,3629,4514,885,24.39%
Grounds Maintenance Worker 2,4110,4,3629,4514,885,24.39%
Grounds Maintenance Worker 2,4110,5,3790,4714,924,24.38%
Grounds Maintenance Worker 2,4110,5,3790,4714,924,24.38%
Grounds Maintenance Worker 2,4110,6,3964,4930,966,24.37%
Grounds Maintenance Worker 2,4110,6,3964,4930,966,24.37%
Grounds Maintenance Worker 2,4110,7,4155,5168,1013,24.38%
Grounds Maintenance Worker 2,4110,7,4155,5168,1013,24.38%
Grounds Maintenance Worker 2,4110,8,4356,5418,1062,24.38%
Grounds Maintenance Worker 2,4110,8,4356,5418,1062,24.38%
Grounds Maintenance Worker 2,4110,9,4555,5411,856,18.79%
Grounds Maintenance Worker 2,4110,9,4555,5411,856,18.79%
Grounds Maintenance Worker 2,4110,10,4776,5419,643,13.46%
Grounds Maintenance Worker 2,4110,10,4776,5419,643,13.46%
Group Life Coordinator 1,6750,1,3005,3913,908,30.22%
Group Life Coordinator 1,6750,2,3095,3849,754,24.36%
Group Life Coordinator 1,6750,3,3218,4002,784,24.36%
Group Life Coordinator 1,6750,4,3335,4148,813,24.38%
Group Life Coordinator 1,6750,5,3483,4332,849,24.38%
Group Life Coordinator 1,6750,6,3629,4514,885,24.39%
Group Life Coordinator 1,6750,7,3790,4714,924,24.38%
Group Life Coordinator 1,6750,8,3964,4930,966,24.37%
Group Life Coordinator 1,6750,9,4155,4936,781,18.80%
Group Life Coordinator 1,6750,10,4356,4943,587,13.48%
Group Life Coordinator 2,6751,1,3483,4536,1053,30.23%
Group Life Coordinator 2,6751,2,3629,4514,885,24.39%
Group Life Coordinator 2,6751,3,3790,4714,924,24.38%
Group Life Coordinator 2,6751,4,3964,4930,966,24.37%
Group Life Coordinator 2,6751,5,4155,5168,1013,24.38%
Group Life Coordinator 2,6751,6,4356,5418,1062,24.38%
Group Life Coordinator 2,6751,7,4555,5666,1111,24.39%
Group Life Coordinator 2,6751,8,4776,5941,1165,24.39%
Group Life Coordinator 2,6751,9,5019,5963,944,18.81%
Group Life Coordinator 2,6751,10,5256,5964,708,13.47%
Hairdresser,9300,1,0,0,0,
Hairdresser,9300,2,0,0,0,
Hairdresser,9300,3,0,0,0,
Hairdresser,9300,4,0,0,0,
Hairdresser,9300,5,3335,4148,813,24.38%
Hairdresser,9300,6,3483,4332,849,24.38%
Hairdresser,9300,7,3629,4514,885,24.39%
Hairdresser,9300,8,3790,4714,924,24.38%
Hairdresser,9300,9,3964,4709,745,18.79%
Hairdresser,9300,10,4155,4714,559,13.45%
Health Care Investigator/Advisor,5911,1,4776,5941,1165,24.39%
Health Care Investigator/Advisor,5911,2,5019,6243,1224,24.39%
Health Care Investigator/Advisor,5911,3,5256,6538,1282,24.39%
Health Care Investigator/Advisor,5911,4,5503,6845,1342,24.39%
Health Care Investigator/Advisor,5911,5,5771,7178,1407,24.38%
Health Care Investigator/Advisor,5911,6,6051,7527,1476,24.39%
Health Care Investigator/Advisor,5911,7,6350,7898,1548,24.38%
Health Care Investigator/Advisor,5911,8,6664,8289,1625,24.38%
Health Care Investigator/Advisor,5911,9,6982,8295,1313,18.81%
Health Care Investigator/Advisor,5911,10,7327,8314,987,13.47%
Health Information Specialist,15,1,3335,4148,813,24.38%
Health Information Specialist,15,2,3483,4332,849,24.38%
Health Information Specialist,15,3,3629,4514,885,24.39%
Health Information Specialist,15,4,3790,4714,924,24.38%
Health Information Specialist,15,5,3964,4930,966,24.37%
Health Information Specialist,15,6,4155,5168,1013,24.38%
Health Information Specialist,15,7,4356,5418,1062,24.38%
Health Information Specialist,15,8,4555,5666,1111,24.39%
Health Information Specialist,15,9,4776,5674,898,18.80%
Health Information Specialist,15,10,5019,5695,676,13.47%
Heavy Equipment Technician 1,4437,1,0,0,0,
Heavy Equipment Technician 1,4437,2,0,0,0,
Heavy Equipment Technician 1,4437,3,0,0,0,
Heavy Equipment Technician 1,4437,4,0,0,0,
Heavy Equipment Technician 1,4437,5,5193,6459,1266,24.38%
Heavy Equipment Technician 1,4437,6,5441,6768,1327,24.39%
Heavy Equipment Technician 1,4437,7,5701,7091,1390,24.38%
Heavy Equipment Technician 1,4437,8,5977,7434,1457,24.38%
Heavy Equipment Technician 1,4437,9,6261,7438,1177,18.80%
Heavy Equipment Technician 1,4437,10,6558,7441,883,13.46%
Heavy Equipment Technician 2,4438,1,0,0,0,
Heavy Equipment Technician 2,4438,2,0,0,0,
Heavy Equipment Technician 2,4438,3,0,0,0,
Heavy Equipment Technician 2,4438,4,0,0,0,
Heavy Equipment Technician 2,4438,5,5771,7178,1407,24.38%
Heavy Equipment Technician 2,4438,6,6051,7527,1476,24.39%
Heavy Equipment Technician 2,4438,7,6350,7898,1548,24.38%
Heavy Equipment Technician 2,4438,8,6664,8289,1625,24.38%
Heavy Equipment Technician 2,4438,9,6982,8295,1313,18.81%
Heavy Equipment Technician 2,4438,10,7317,8303,986,13.48%
Human Services Assistant 2,6606,1,3095,3849,754,24.36%
Human Services Assistant 2,6606,2,3218,4002,784,24.36%
Human Services Assistant 2,6606,3,3335,4148,813,24.38%
Human Services Assistant 2,6606,4,3483,4332,849,24.38%
Human Services Assistant 2,6606,5,3629,4514,885,24.39%
Human Services Assistant 2,6606,6,3790,4714,924,24.38%
Human Services Assistant 2,6606,7,3964,4930,966,24.37%
Human Services Assistant 2,6606,8,4155,5168,1013,24.38%
Human Services Assistant 2,6606,9,4356,5175,819,18.80%
Human Services Assistant 2,6606,10,4555,5168,613,13.46%
Human Services Case Manager,6630,1,3790,4714,924,24.38%
Human Services Case Manager,6630,2,3964,4930,966,24.37%
Human Services Case Manager,6630,3,4155,5168,1013,24.38%
Human Services Case Manager,6630,4,4356,5418,1062,24.38%
Human Services Case Manager,6630,5,4555,5666,1111,24.39%
Human Services Case Manager,6630,6,4776,5941,1165,24.39%
Human Services Case Manager,6630,7,5019,6243,1224,24.39%
Human Services Case Manager,6630,8,5256,6538,1282,24.39%
Human Services Case Manager,6630,9,5503,6538,1035,18.81%
Human Services Case Manager,6630,10,5771,6548,777,13.46%
Human Services Specialist 1,6657,1,3005,3738,733,24.39%
Human Services Specialist 1,6657,2,3095,3849,754,24.36%
Human Services Specialist 1,6657,3,3218,4002,784,24.36%
Human Services Specialist 1,6657,4,3335,4148,813,24.38%
Human Services Specialist 1,6657,5,3483,4332,849,24.38%
Human Services Specialist 1,6657,6,3629,4514,885,24.39%
Human Services Specialist 1,6657,7,3790,4714,924,24.38%
Human Services Specialist 1,6657,8,3964,4930,966,24.37%
Human Services Specialist 1,6657,9,4155,4936,781,18.80%
Human Services Specialist 1,6657,10,4356,4943,587,13.48%
Human Services Specialist 2,6658,1,3218,4002,784,24.36%
Human Services Specialist 2,6658,2,3335,4148,813,24.38%
Human Services Specialist 2,6658,3,3483,4332,849,24.38%
Human Services Specialist 2,6658,4,3629,4514,885,24.39%
Human Services Specialist 2,6658,5,3790,4714,924,24.38%
Human Services Specialist 2,6658,6,3964,4930,966,24.37%
Human Services Specialist 2,6658,7,4155,5168,1013,24.38%
Human Services Specialist 2,6658,8,4356,5418,1062,24.38%
Human Services Specialist 2,6658,9,4555,5411,856,18.79%
Human Services Specialist 2,6658,10,4776,5419,643,13.46%
Human Services Specialist 3,6659,1,3483,4332,849,24.38%
Human Services Specialist 3,6659,2,3629,4514,885,24.39%
Human Services Specialist 3,6659,3,3790,4714,924,24.38%
Human Services Specialist 3,6659,4,3964,4930,966,24.37%
Human Services Specialist 3,6659,5,4155,5168,1013,24.38%
Human Services Specialist 3,6659,6,4356,5418,1062,24.38%
Human Services Specialist 3,6659,7,4555,5666,1111,24.39%
Human Services Specialist 3,6659,8,4776,5941,1165,24.39%
Human Services Specialist 3,6659,9,5019,5963,944,18.81%
Human Services Specialist 3,6659,10,5256,5964,708,13.47%
Human Services Specialist 4,6660,1,3964,4930,966,24.37%
Human Services Specialist 4,6660,2,4155,5168,1013,24.38%
Human Services Specialist 4,6660,3,4356,5418,1062,24.38%
Human Services Specialist 4,6660,4,4555,5666,1111,24.39%
Human Services Specialist 4,6660,5,4776,5941,1165,24.39%
Human Services Specialist 4,6660,6,5019,6243,1224,24.39%
Human Services Specialist 4,6660,7,5256,6538,1282,24.39%
Human Services Specialist 4,6660,8,5503,6845,1342,24.39%
Human Services Specialist 4,6660,9,5771,6856,1085,18.80%
Human Services Specialist 4,6660,10,6051,6866,815,13.47%
Incident Response Operations Specialist,4165,1,3629,4514,885,24.39%
Incident Response Operations Specialist,4165,2,3790,4714,924,24.38%
Incident Response Operations Specialist,4165,3,3964,4930,966,24.37%
Incident Response Operations Specialist,4165,4,4155,5168,1013,24.38%
Incident Response Operations Specialist,4165,5,4356,5418,1062,24.38%
Incident Response Operations Specialist,4165,6,4555,5666,1111,24.39%
Incident Response Operations Specialist,4165,7,4776,5941,1165,24.39%
Incident Response Operations Specialist,4165,8,5019,6243,1224,24.39%
Incident Response Operations Specialist,4165,9,5256,6244,988,18.80%
Incident Response Operations Specialist,4165,10,5503,6244,741,13.47%
Industrial Hygienist 2,5706,1,5019,6243,1224,24.39%
Industrial Hygienist 2,5706,2,5256,6538,1282,24.39%
Industrial Hygienist 2,5706,3,5503,6845,1342,24.39%
Industrial Hygienist 2,5706,4,5771,7178,1407,24.38%
Industrial Hygienist 2,5706,5,6051,7527,1476,24.39%
Industrial Hygienist 2,5706,6,6350,7898,1548,24.38%
Industrial Hygienist 2,5706,7,6664,8289,1625,24.38%
Industrial Hygienist 2,5706,8,6982,8685,1703,24.39%
Industrial Hygienist 2,5706,9,7327,8705,1378,18.81%
Industrial Hygienist 2,5706,10,7678,8712,1034,13.47%
Industrial Hygienist 3,5707,1,5503,6845,1342,24.39%
Industrial Hygienist 3,5707,2,5771,7178,1407,24.38%
Industrial Hygienist 3,5707,3,6051,7527,1476,24.39%
Industrial Hygienist 3,5707,4,6350,7898,1548,24.38%
Industrial Hygienist 3,5707,5,6664,8289,1625,24.38%
Industrial Hygienist 3,5707,6,6982,8685,1703,24.39%
Industrial Hygienist 3,5707,7,7327,9114,1787,24.39%
Industrial Hygienist 3,5707,8,7678,9550,1872,24.38%
Industrial Hygienist 3,5707,9,8057,9572,1515,18.80%
Industrial Hygienist 3,5707,10,8450,9588,1138,13.47%
Industrial Hygienist 4,5708,1,6051,7527,1476,24.39%
Industrial Hygienist 4,5708,2,6350,7898,1548,24.38%
Industrial Hygienist 4,5708,3,6664,8289,1625,24.38%
Industrial Hygienist 4,5708,4,6982,8685,1703,24.39%
Industrial Hygienist 4,5708,5,7327,9114,1787,24.39%
Industrial Hygienist 4,5708,6,7678,9550,1872,24.38%
Industrial Hygienist 4,5708,7,8057,10022,1965,24.39%
Industrial Hygienist 4,5708,8,8450,10511,2061,24.39%
Industrial Hygienist 4,5708,9,8870,10538,1668,18.80%
Industrial Hygienist 4,5708,10,9293,10545,1252,13.47%
Information Systems Specialist 2,1483,1,3790,4714,924,24.38%
Information Systems Specialist 2,1483,2,3964,4930,966,24.37%
Information Systems Specialist 2,1483,3,4155,5168,1013,24.38%
Information Systems Specialist 2,1483,4,4356,5418,1062,24.38%
Information Systems Specialist 2,1483,5,4555,5666,1111,24.39%
Information Systems Specialist 2,1483,6,4776,5941,1165,24.39%
Information Systems Specialist 2,1483,7,5019,6243,1224,24.39%
Information Systems Specialist 2,1483,8,5256,6538,1282,24.39%
Information Systems Specialist 2,1483,9,5503,6538,1035,18.81%
Information Systems Specialist 2,1483,10,5771,6548,777,13.46%
Information Systems Specialist 3,1483,1,4356,5418,1062,24.38%
Information Systems Specialist 3,1483,2,4555,5666,1111,24.39%
Information Systems Specialist 3,1483,3,4776,5941,1165,24.39%
Information Systems Specialist 3,1483,4,5019,6243,1224,24.39%
Information Systems Specialist 3,1483,5,5256,6538,1282,24.39%
Information Systems Specialist 3,1483,6,5503,6845,1342,24.39%
Information Systems Specialist 3,1483,7,5771,7178,1407,24.38%
Information Systems Specialist 3,1483,8,6051,7527,1476,24.39%
Information Systems Specialist 3,1483,9,6350,7544,1194,18.80%
Information Systems Specialist 3,1483,10,6664,7562,898,13.48%
Information Systems Specialist 4,1484,1,4555,5666,1111,24.39%
Information Systems Specialist 4,1484,2,4776,5941,1165,24.39%
Information Systems Specialist 4,1484,3,5019,6243,1224,24.39%
Information Systems Specialist 4,1484,4,5256,6538,1282,24.39%
Information Systems Specialist 4,1484,5,5503,6845,1342,24.39%
Information Systems Specialist 4,1484,6,5771,7178,1407,24.38%
Information Systems Specialist 4,1484,7,6051,7527,1476,24.39%
Information Systems Specialist 4,1484,8,6350,7898,1548,24.38%
Information Systems Specialist 4,1484,9,6664,7917,1253,18.80%
Information Systems Specialist 4,1484,10,6982,7922,940,13.46%
Information Systems Specialist 5,1485,1,5256,6538,1282,24.39%
Information Systems Specialist 5,1485,1,5256,6538,1282,24.39%
Information Systems Specialist 5,1485,2,5503,6845,1342,24.39%
Information Systems Specialist 5,1485,2,5503,6845,1342,24.39%
Information Systems Specialist 5,1485,3,5771,7178,1407,24.38%
Information Systems Specialist 5,1485,3,5771,7178,1407,24.38%
Information Systems Specialist 5,1485,4,6051,7527,1476,24.39%
Information Systems Specialist 5,1485,4,6051,7527,1476,24.39%
Information Systems Specialist 5,1485,5,6350,7898,1548,24.38%
Information Systems Specialist 5,1485,5,6350,7898,1548,24.38%
Information Systems Specialist 5,1485,6,6664,8289,1625,24.38%
Information Systems Specialist 5,1485,6,6664,8289,1625,24.38%
Information Systems Specialist 5,1485,7,6982,8685,1703,24.39%
Information Systems Specialist 5,1485,7,6982,8685,1703,24.39%
Information Systems Specialist 5,1485,8,7327,9114,1787,24.39%
Information Systems Specialist 5,1485,8,7327,9114,1787,24.39%
Information Systems Specialist 5,1485,9,7678,9122,1444,18.81%
Information Systems Specialist 5,1485,9,7678,9122,1444,18.81%
Information Systems Specialist 5,1485,10,8057,9142,1085,13.47%
Information Systems Specialist 5,1485,10,8057,9142,1085,13.47%
Information Systems Specialist 6,1486,1,5503,6845,1342,24.39%
Information Systems Specialist 6,1486,1,5503,6845,1342,24.39%
Information Systems Specialist 6,1486,2,5771,7178,1407,24.38%
Information Systems Specialist 6,1486,2,5771,7178,1407,24.38%
Information Systems Specialist 6,1486,3,6051,7527,1476,24.39%
Information Systems Specialist 6,1486,3,6051,7527,1476,24.39%
Information Systems Specialist 6,1486,4,6350,7898,1548,24.38%
Information Systems Specialist 6,1486,4,6350,7898,1548,24.38%
Information Systems Specialist 6,1486,5,6664,8289,1625,24.38%
Information Systems Specialist 6,1486,5,6664,8289,1625,24.38%
Information Systems Specialist 6,1486,6,6982,8685,1703,24.39%
Information Systems Specialist 6,1486,6,6982,8685,1703,24.39%
Information Systems Specialist 6,1486,7,7327,9114,1787,24.39%
Information Systems Specialist 6,1486,7,7327,9114,1787,24.39%
Information Systems Specialist 6,1486,8,7678,9550,1872,24.38%
Information Systems Specialist 6,1486,8,7678,9550,1872,24.38%
Information Systems Specialist 6,1486,9,8057,9572,1515,18.80%
Information Systems Specialist 6,1486,9,8057,9572,1515,18.80%
Information Systems Specialist 6,1486,10,8450,9588,1138,13.47%
Information Systems Specialist 6,1486,10,8450,9588,1138,13.47%
Information Systems Specialist 7,1487,1,5503,6845,1342,24.39%
Information Systems Specialist 7,1487,1,6051,7527,1476,24.39%
Information Systems Specialist 7,1487,2,5771,7178,1407,24.38%
Information Systems Specialist 7,1487,2,6350,7898,1548,24.38%
Information Systems Specialist 7,1487,3,6051,7527,1476,24.39%
Information Systems Specialist 7,1487,3,6664,8289,1625,24.38%
Information Systems Specialist 7,1487,4,6350,7898,1548,24.38%
Information Systems Specialist 7,1487,4,6982,8685,1703,24.39%
Information Systems Specialist 7,1487,5,6664,8289,1625,24.38%
Information Systems Specialist 7,1487,5,7327,9114,1787,24.39%
Information Systems Specialist 7,1487,6,6982,8685,1703,24.39%
Information Systems Specialist 7,1487,6,7678,9550,1872,24.38%
Information Systems Specialist 7,1487,7,7327,9114,1787,24.39%
Information Systems Specialist 7,1487,7,8057,10022,1965,24.39%
Information Systems Specialist 7,1487,8,7678,9550,1872,24.38%
Information Systems Specialist 7,1487,8,8450,10511,2061,24.39%
Information Systems Specialist 7,1487,9,8057,9572,1515,18.80%
Information Systems Specialist 7,1487,9,8870,10538,1668,18.80%
Information Systems Specialist 7,1487,10,8450,9588,1138,13.47%
Information Systems Specialist 7,1487,10,9293,10545,1252,13.47%
Information Systems Specialist 8,1488,1,6051,7527,1476,24.39%
Information Systems Specialist 8,1488,2,6350,7898,1548,24.38%
Information Systems Specialist 8,1488,3,6664,8289,1625,24.38%
Information Systems Specialist 8,1488,4,6982,8685,1703,24.39%
Information Systems Specialist 8,1488,5,7327,9114,1787,24.39%
Information Systems Specialist 8,1488,6,7678,9550,1872,24.38%
Information Systems Specialist 8,1488,7,8057,10022,1965,24.39%
Information Systems Specialist 8,1488,8,8450,10511,2061,24.39%
Information Systems Specialist 8,1488,9,8870,10538,1668,18.80%
Information Systems Specialist 8,1488,10,9293,10545,1252,13.47%
Institution Registered Nurse,6314,1,6756,8404,1648,24.39%
Institution Registered Nurse,6314,2,7074,8799,1725,24.39%
Institution Registered Nurse,6314,3,7410,9217,1807,24.39%
Institution Registered Nurse,6314,4,7764,9657,1893,24.38%
Institution Registered Nurse,6314,5,8130,10113,1983,24.39%
Institution Registered Nurse,6314,6,8519,10597,2078,24.39%
Institution Registered Nurse,6314,7,8964,11150,2186,24.39%
Institution Registered Nurse,6314,8,9345,11624,2279,24.39%
Institution Registered Nurse,6314,9,9789,11630,1841,18.81%
Institution Registered Nurse,6314,10,10254,11635,1381,13.47%
Insurance Examiner,5748,1,5771,7178,1407,24.38%
Insurance Examiner,5748,1,5771,7178,1407,24.38%
Insurance Examiner,5748,2,6051,7527,1476,24.39%
Insurance Examiner,5748,2,6051,7527,1476,24.39%
Insurance Examiner,5748,3,6350,7898,1548,24.38%
Insurance Examiner,5748,3,6350,7898,1548,24.38%
Insurance Examiner,5748,4,6664,8289,1625,24.38%
Insurance Examiner,5748,4,6664,8289,1625,24.38%
Insurance Examiner,5748,5,6982,8685,1703,24.39%
Insurance Examiner,5748,5,6982,8685,1703,24.39%
Insurance Examiner,5748,6,7327,9114,1787,24.39%
Insurance Examiner,5748,6,7327,9114,1787,24.39%
Insurance Examiner,5748,7,7678,9550,1872,24.38%
Insurance Examiner,5748,7,7678,9550,1872,24.38%
Insurance Examiner,5748,8,8057,10022,1965,24.39%
Insurance Examiner,5748,8,8057,10022,1965,24.39%
Insurance Examiner,5748,9,8450,10039,1589,18.80%
Insurance Examiner,5748,9,8450,10039,1589,18.80%
Insurance Examiner,5748,10,8870,10065,1195,13.47%
Insurance Examiner,5748,10,8870,10065,1195,13.47%
Insurance Examiner Entry,5747,1,4776,5941,1165,24.39%
Insurance Examiner Entry,5747,2,5019,6243,1224,24.39%
Insurance Examiner Entry,5747,3,5256,6538,1282,24.39%
Insurance Examiner Entry,5747,4,5503,6845,1342,24.39%
Insurance Examiner Entry,5747,5,5771,7178,1407,24.38%
Insurance Examiner Entry,5747,6,6051,7527,1476,24.39%
Insurance Examiner Entry,5747,7,6350,7898,1548,24.38%
Insurance Examiner Entry,5747,8,6664,8289,1625,24.38%
Insurance Examiner Entry,5747,9,6982,8295,1313,18.81%
Insurance Examiner Entry,5747,10,7327,8314,987,13.47%
Investigator 1,5331,1,3483,4332,849,24.38%
Investigator 1,5331,2,3629,4514,885,24.39%
Investigator 1,5331,3,3790,4714,924,24.38%
Investigator 1,5331,4,3964,4930,966,24.37%
Investigator 1,5331,5,4155,5168,1013,24.38%
Investigator 1,5331,6,4356,5418,1062,24.38%
Investigator 1,5331,7,4555,5666,1111,24.39%
Investigator 1,5331,8,4776,5941,1165,24.39%
Investigator 1,5331,9,5019,5963,944,18.81%
Investigator 1,5331,10,5256,5964,708,13.47%
Investigator 2,5333,1,4155,5168,1013,24.38%
Investigator 2,5333,2,4356,5418,1062,24.38%
Investigator 2,5333,3,4555,5666,1111,24.39%
Investigator 2,5333,4,4776,5941,1165,24.39%
Investigator 2,5333,5,5019,6243,1224,24.39%
Investigator 2,5333,6,5256,6538,1282,24.39%
Investigator 2,5333,7,5503,6845,1342,24.39%
Investigator 2,5333,8,5771,7178,1407,24.38%
Investigator 2,5333,9,6051,7189,1138,18.81%
Investigator 2,5333,10,6350,7205,855,13.46%
Investigator 3,5333,1,4776,5941,1165,24.39%
Investigator 3,5333,2,5019,6243,1224,24.39%
Investigator 3,5333,3,5256,6538,1282,24.39%
Investigator 3,5333,4,5503,6845,1342,24.39%
Investigator 3,5333,5,5771,7178,1407,24.38%
Investigator 3,5333,6,6051,7527,1476,24.39%
Investigator 3,5333,7,6350,7898,1548,24.38%
Investigator 3,5333,8,6664,8289,1625,24.38%
Investigator 3,5333,9,6982,8295,1313,18.81%
Investigator 3,5333,10,7327,8314,987,13.47%
Investment Analyst 1,1333,1,5019,6243,1224,24.39%
Investment Analyst 1,1333,2,5256,6538,1282,24.39%
Investment Analyst 1,1333,3,5503,6845,1342,24.39%
Investment Analyst 1,1333,4,5771,7178,1407,24.38%
Investment Analyst 1,1333,5,6051,7527,1476,24.39%
Investment Analyst 1,1333,6,6350,7898,1548,24.38%
Investment Analyst 1,1333,7,6664,8289,1625,24.38%
Investment Analyst 1,1333,8,6982,8685,1703,24.39%
Investment Analyst 1,1333,9,7327,8705,1378,18.81%
Investment Analyst 1,1333,10,7678,8712,1034,13.47%
Investment Analyst 2,1333,1,5771,7178,1407,24.38%
Investment Analyst 2,1333,2,6051,7527,1476,24.39%
Investment Analyst 2,1333,3,6350,7898,1548,24.38%
Investment Analyst 2,1333,4,6664,8289,1625,24.38%
Investment Analyst 2,1333,5,6982,8685,1703,24.39%
Investment Analyst 2,1333,6,7327,9114,1787,24.39%
Investment Analyst 2,1333,7,7678,9550,1872,24.38%
Investment Analyst 2,1333,8,8057,10022,1965,24.39%
Investment Analyst 2,1333,9,8450,10039,1589,18.80%
Investment Analyst 2,1333,10,8870,10065,1195,13.47%
Investment Analyst 3,1334,1,6664,8289,1625,24.38%
Investment Analyst 3,1334,2,6982,8685,1703,24.39%
Investment Analyst 3,1334,3,7327,9114,1787,24.39%
Investment Analyst 3,1334,4,7678,9550,1872,24.38%
Investment Analyst 3,1334,5,8057,10022,1965,24.39%
Investment Analyst 3,1334,6,8450,10511,2061,24.39%
Investment Analyst 3,1334,7,8870,11033,2163,24.39%
Investment Analyst 3,1334,8,9293,11559,2266,24.38%
Investment Analyst 3,1334,9,9751,11585,1834,18.81%
Investment Analyst 3,1334,10,10242,11622,1380,13.47%
Juvenile Probation/Social Services Officer/Juvenile Correction Counselor,6633,1,4356,5418,1062,24.38%
Juvenile Probation/Social Services Officer/Juvenile Correction Counselor,6633,2,4555,5666,1111,24.39%
Juvenile Probation/Social Services Officer/Juvenile Correction Counselor,6633,3,4776,5941,1165,24.39%
Juvenile Probation/Social Services Officer/Juvenile Correction Counselor,6633,4,5019,6243,1224,24.39%
Juvenile Probation/Social Services Officer/Juvenile Correction Counselor,6633,5,5256,6538,1282,24.39%
Juvenile Probation/Social Services Officer/Juvenile Correction Counselor,6633,6,5503,6845,1342,24.39%
Juvenile Probation/Social Services Officer/Juvenile Correction Counselor,6633,7,5771,7178,1407,24.38%
Juvenile Probation/Social Services Officer/Juvenile Correction Counselor,6633,8,6051,7527,1476,24.39%
Juvenile Probation/Social Services Officer/Juvenile Correction Counselor,6633,9,6350,7544,1194,18.80%
Juvenile Probation/Social Services Officer/Juvenile Correction Counselor,6633,10,6664,7562,898,13.48%
Laboratory Technician 2,6811,1,3218,4002,784,24.36%
Laboratory Technician 2,6811,2,3335,4148,813,24.38%
Laboratory Technician 2,6811,3,3483,4332,849,24.38%
Laboratory Technician 2,6811,4,3629,4514,885,24.39%
Laboratory Technician 2,6811,5,3790,4714,924,24.38%
Laboratory Technician 2,6811,6,3964,4930,966,24.37%
Laboratory Technician 2,6811,7,4155,5168,1013,24.38%
Laboratory Technician 2,6811,8,4356,5418,1062,24.38%
Laboratory Technician 2,6811,9,4555,5411,856,18.79%
Laboratory Technician 2,6811,10,4776,5419,643,13.46%
Laborer/Student Worker,4116,1,0,0,0,
Laborer/Student Worker,4116,2,0,0,0,
Laborer/Student Worker,4116,3,0,0,0,
Laborer/Student Worker,4116,4,3005,3738,733,24.39%
Laborer/Student Worker,4116,5,3095,3849,754,24.36%
Laborer/Student Worker,4116,6,3218,4002,784,24.36%
Laborer/Student Worker,4116,7,3335,4148,813,24.38%
Laborer/Student Worker,4116,8,3483,4332,849,24.38%
Laborer/Student Worker,4116,9,3629,4311,682,18.79%
Laborer/Student Worker,4116,10,3790,4300,510,13.46%
Legal Secretary,110,1,3335,4148,813,24.38%
Legal Secretary,110,2,3483,4332,849,24.38%
Legal Secretary,110,3,3629,4514,885,24.39%
Legal Secretary,110,4,3790,4714,924,24.38%
Legal Secretary,110,5,3964,4930,966,24.37%
Legal Secretary,110,6,4155,5168,1013,24.38%
Legal Secretary,110,7,4356,5418,1062,24.38%
Legal Secretary,110,8,4555,5666,1111,24.39%
Legal Secretary,110,9,4776,5674,898,18.80%
Legal Secretary,110,10,5019,5695,676,13.47%
Librarian,3330,1,4776,5941,1165,24.39%
Librarian,3330,2,5019,6243,1224,24.39%
Librarian,3330,3,5256,6538,1282,24.39%
Librarian,3330,4,5503,6845,1342,24.39%
Librarian,3330,5,5771,7178,1407,24.38%
Librarian,3330,6,6051,7527,1476,24.39%
Librarian,3330,7,6350,7898,1548,24.38%
Librarian,3330,8,6664,8289,1625,24.38%
Librarian,3330,9,6982,8295,1313,18.81%
Librarian,3330,10,7327,8314,987,13.47%
Licensed Practical Nurse,6135,1,4131,5138,1007,24.38%
Licensed Practical Nurse,6135,2,4339,5397,1058,24.38%
Licensed Practical Nurse,6135,3,4558,5669,1111,24.37%
Licensed Practical Nurse,6135,4,4758,5918,1160,24.38%
Licensed Practical Nurse,6135,5,4982,6197,1215,24.39%
Licensed Practical Nurse,6135,6,5251,6531,1280,24.38%
Licensed Practical Nurse,6135,7,5493,6832,1339,24.38%
Licensed Practical Nurse,6135,8,5732,7130,1398,24.39%
Licensed Practical Nurse,6135,9,6009,7139,1130,18.81%
Licensed Practical Nurse,6135,10,6298,7146,848,13.46%
Livestock Brand Inspector,5430,1,3005,3738,733,24.39%
Livestock Brand Inspector,5430,2,3095,3849,754,24.36%
Livestock Brand Inspector,5430,3,3218,4002,784,24.36%
Livestock Brand Inspector,5430,4,3335,4148,813,24.38%
Livestock Brand Inspector,5430,5,3483,4332,849,24.38%
Livestock Brand Inspector,5430,6,3629,4514,885,24.39%
Livestock Brand Inspector,5430,7,3790,4714,924,24.38%
Livestock Brand Inspector,5430,8,3964,4930,966,24.37%
Livestock Brand Inspector,5430,9,4155,4936,781,18.80%
Livestock Brand Inspector,5430,10,4356,4943,587,13.48%
Loan Specialist 1,1001,1,4155,5168,1013,24.38%
Loan Specialist 1,1001,2,4356,5418,1062,24.38%
Loan Specialist 1,1001,3,4555,5666,1111,24.39%
Loan Specialist 1,1001,4,4776,5941,1165,24.39%
Loan Specialist 1,1001,5,5019,6243,1224,24.39%
Loan Specialist 1,1001,6,5256,6538,1282,24.39%
Loan Specialist 1,1001,7,5503,6845,1342,24.39%
Loan Specialist 1,1001,8,5771,7178,1407,24.38%
Loan Specialist 1,1001,9,6051,7189,1138,18.81%
Loan Specialist 1,1001,10,6350,7205,855,13.46%
Loan Specialist 2,1003,1,5019,6243,1224,24.39%
Loan Specialist 2,1003,2,5256,6538,1282,24.39%
Loan Specialist 2,1003,3,5503,6845,1342,24.39%
Loan Specialist 2,1003,4,5771,7178,1407,24.38%
Loan Specialist 2,1003,5,6051,7527,1476,24.39%
Loan Specialist 2,1003,6,6350,7898,1548,24.38%
Loan Specialist 2,1003,7,6664,8289,1625,24.38%
Loan Specialist 2,1003,8,6982,8685,1703,24.39%
Loan Specialist 2,1003,9,7327,8705,1378,18.81%
Loan Specialist 2,1003,10,7678,8712,1034,13.47%
Loan Specialist 3,1003,1,5771,7178,1407,24.38%
Loan Specialist 3,1003,2,6051,7527,1476,24.39%
Loan Specialist 3,1003,3,6350,7898,1548,24.38%
Loan Specialist 3,1003,4,6664,8289,1625,24.38%
Loan Specialist 3,1003,5,6982,8685,1703,24.39%
Loan Specialist 3,1003,6,7327,9114,1787,24.39%
Loan Specialist 3,1003,7,7678,9550,1872,24.38%
Loan Specialist 3,1003,8,8057,10022,1965,24.39%
Loan Specialist 3,1003,9,8450,10039,1589,18.80%
Loan Specialist 3,1003,10,8870,10065,1195,13.47%
Machinist,4018,1,4776,5941,1165,24.39%
Machinist,4018,2,5019,6243,1224,24.39%
Machinist,4018,3,5256,6538,1282,24.39%
Machinist,4018,4,5503,6845,1342,24.39%
Machinist,4018,5,5771,7178,1407,24.38%
Machinist,4018,6,6051,7527,1476,24.39%
Machinist,4018,7,6350,7898,1548,24.38%
Machinist,4018,8,6664,8289,1625,24.38%
Machinist,4018,9,6982,8295,1313,18.81%
Machinist,4018,10,7327,8314,987,13.47%
Mail Delivery Driver,4404,1,3005,3738,733,24.39%
Mail Delivery Driver,4404,2,3095,3849,754,24.36%
Mail Delivery Driver,4404,3,3218,4002,784,24.36%
Mail Delivery Driver,4404,4,3335,4148,813,24.38%
Mail Delivery Driver,4404,5,3483,4332,849,24.38%
Mail Delivery Driver,4404,6,3629,4514,885,24.39%
Mail Delivery Driver,4404,7,3790,4714,924,24.38%
Mail Delivery Driver,4404,8,3964,4930,966,24.37%
Mail Delivery Driver,4404,9,4155,4936,781,18.80%
Mail Delivery Driver,4404,10,4356,4943,587,13.48%
Mail Equipment Operator 1,403,1,0,0,0,
Mail Equipment Operator 1,403,2,0,0,0,
Mail Equipment Operator 1,403,3,0,0,0,
Mail Equipment Operator 1,403,4,3005,3738,733,24.39%
Mail Equipment Operator 1,403,5,3095,3849,754,24.36%
Mail Equipment Operator 1,403,6,3218,4002,784,24.36%
Mail Equipment Operator 1,403,7,3335,4148,813,24.38%
Mail Equipment Operator 1,403,8,3483,4332,849,24.38%
Mail Equipment Operator 1,403,9,3629,4311,682,18.79%
Mail Equipment Operator 1,403,10,3790,4300,510,13.46%
Mail Equipment Operator 2,404,1,3005,3738,733,24.39%
Mail Equipment Operator 2,404,2,3095,3849,754,24.36%
Mail Equipment Operator 2,404,3,3218,4002,784,24.36%
Mail Equipment Operator 2,404,4,3335,4148,813,24.38%
Mail Equipment Operator 2,404,5,3483,4332,849,24.38%
Mail Equipment Operator 2,404,6,3629,4514,885,24.39%
Mail Equipment Operator 2,404,7,3790,4714,924,24.38%
Mail Equipment Operator 2,404,8,3964,4930,966,24.37%
Mail Equipment Operator 2,404,9,4155,4936,781,18.80%
Mail Equipment Operator 2,404,10,4356,4943,587,13.48%
Mail Services Assistant,405,1,0,0,0,
Mail Services Assistant,405,2,0,0,0,
Mail Services Assistant,405,3,3005,3738,733,24.39%
Mail Services Assistant,405,4,3095,3849,754,24.36%
Mail Services Assistant,405,5,3218,4002,784,24.36%
Mail Services Assistant,405,6,3335,4148,813,24.38%
Mail Services Assistant,405,7,3483,4332,849,24.38%
Mail Services Assistant,405,8,3629,4514,885,24.39%
Mail Services Assistant,405,9,3790,4502,712,18.79%
Mail Services Assistant,405,10,3964,4498,534,13.47%
Manual Arts Instructor,3304,1,3218,4191,973,30.24%
Manual Arts Instructor,3304,2,3335,4148,813,24.38%
Manual Arts Instructor,3304,3,3483,4332,849,24.38%
Manual Arts Instructor,3304,4,3629,4514,885,24.39%
Manual Arts Instructor,3304,5,3790,4714,924,24.38%
Manual Arts Instructor,3304,6,3964,4930,966,24.37%
Manual Arts Instructor,3304,7,4155,5168,1013,24.38%
Manual Arts Instructor,3304,8,4356,5418,1062,24.38%
Manual Arts Instructor,3304,9,4555,5411,856,18.79%
Manual Arts Instructor,3304,10,4776,5419,643,13.46%
Medical Consultant,7538,1,8870,11033,2163,24.39%
Medical Consultant,7538,2,9293,11559,2266,24.38%
Medical Consultant,7538,3,9751,12129,2378,24.39%
Medical Consultant,7538,4,10242,12740,2498,24.39%
Medical Consultant,7538,5,10740,13359,2619,24.39%
Medical Consultant,7538,6,11267,14015,2748,24.39%
Medical Consultant,7538,7,11825,14709,2884,24.39%
Medical Consultant,7538,8,12408,15434,3026,24.39%
Medical Consultant,7538,9,13020,15468,2448,18.80%
Medical Consultant,7538,10,13662,15503,1841,13.48%
Medical Laboratory Technician 1,6830,1,3335,4148,813,24.38%
Medical Laboratory Technician 1,6830,2,3483,4332,849,24.38%
Medical Laboratory Technician 1,6830,3,3629,4514,885,24.39%
Medical Laboratory Technician 1,6830,4,3790,4714,924,24.38%
Medical Laboratory Technician 1,6830,5,3964,4930,966,24.37%
Medical Laboratory Technician 1,6830,6,4155,5168,1013,24.38%
Medical Laboratory Technician 1,6830,7,4356,5418,1062,24.38%
Medical Laboratory Technician 1,6830,8,4555,5666,1111,24.39%
Medical Laboratory Technician 1,6830,9,4776,5674,898,18.80%
Medical Laboratory Technician 1,6830,10,5019,5695,676,13.47%
Medical Laboratory Technician 2,6831,1,3629,4514,885,24.39%
Medical Laboratory Technician 2,6831,2,3790,4714,924,24.38%
Medical Laboratory Technician 2,6831,3,3964,4930,966,24.37%
Medical Laboratory Technician 2,6831,4,4155,5168,1013,24.38%
Medical Laboratory Technician 2,6831,5,4356,5418,1062,24.38%
Medical Laboratory Technician 2,6831,6,4555,5666,1111,24.39%
Medical Laboratory Technician 2,6831,7,4776,5941,1165,24.39%
Medical Laboratory Technician 2,6831,8,5019,6243,1224,24.39%
Medical Laboratory Technician 2,6831,9,5256,6244,988,18.80%
Medical Laboratory Technician 2,6831,10,5503,6244,741,13.47%
Medical Review Coordinator,6310,1,6756,8404,1648,24.39%
Medical Review Coordinator,6310,2,7074,8799,1725,24.39%
Medical Review Coordinator,6310,3,7410,9217,1807,24.39%
Medical Review Coordinator,6310,4,7764,9657,1893,24.38%
Medical Review Coordinator,6310,5,8130,10113,1983,24.39%
Medical Review Coordinator,6310,6,8519,10597,2078,24.39%
Medical Review Coordinator,6310,7,8964,11150,2186,24.39%
Medical Review Coordinator,6310,8,9345,11624,2279,24.39%
Medical Review Coordinator,6310,9,9789,11630,1841,18.81%
Medical Review Coordinator,6310,10,10254,11635,1381,13.47%
Mental Health Security Technician,6708,1,3218,4191,973,30.24%
Mental Health Security Technician,6708,2,3335,4148,813,24.38%
Mental Health Security Technician,6708,3,3483,4332,849,24.38%
Mental Health Security Technician,6708,4,3629,4514,885,24.39%
Mental Health Security Technician,6708,5,3790,4714,924,24.38%
Mental Health Security Technician,6708,6,3964,4930,966,24.37%
Mental Health Security Technician,6708,7,4155,5168,1013,24.38%
Mental Health Security Technician,6708,8,4356,5418,1062,24.38%
Mental Health Security Technician,6708,9,4555,5411,856,18.79%
Mental Health Security Technician,6708,10,4776,5419,643,13.46%
Mental Health Therapist 1,6711,1,3218,4191,973,30.24%
Mental Health Therapist 1,6711,2,3335,4148,813,24.38%
Mental Health Therapist 1,6711,3,3483,4332,849,24.38%
Mental Health Therapist 1,6711,4,3629,4514,885,24.39%
Mental Health Therapist 1,6711,5,3790,4714,924,24.38%
Mental Health Therapist 1,6711,6,3964,4930,966,24.37%
Mental Health Therapist 1,6711,7,4155,5168,1013,24.38%
Mental Health Therapist 1,6711,8,4356,5418,1062,24.38%
Mental Health Therapist 1,6711,9,4555,5411,856,18.79%
Mental Health Therapist 1,6711,10,4776,5419,643,13.46%
Mental Health Therapist 2,6713,1,3483,4536,1053,30.23%
Mental Health Therapist 2,6713,2,3629,4514,885,24.39%
Mental Health Therapist 2,6713,3,3790,4714,924,24.38%
Mental Health Therapist 2,6713,4,3964,4930,966,24.37%
Mental Health Therapist 2,6713,5,4155,5168,1013,24.38%
Mental Health Therapist 2,6713,6,4356,5418,1062,24.38%
Mental Health Therapist 2,6713,7,4555,5666,1111,24.39%
Mental Health Therapist 2,6713,8,4776,5941,1165,24.39%
Mental Health Therapist 2,6713,9,5019,5963,944,18.81%
Mental Health Therapist 2,6713,10,5256,5964,708,13.47%
Mental Health Therapy Coordinator,6718,1,3483,4536,1053,30.23%
Mental Health Therapy Coordinator,6718,2,3629,4514,885,24.39%
Mental Health Therapy Coordinator,6718,3,3790,4714,924,24.38%
Mental Health Therapy Coordinator,6718,4,3964,4930,966,24.37%
Mental Health Therapy Coordinator,6718,5,4155,5168,1013,24.38%
Mental Health Therapy Coordinator,6718,6,4356,5418,1062,24.38%
Mental Health Therapy Coordinator,6718,7,4555,5666,1111,24.39%
Mental Health Therapy Coordinator,6718,8,4776,5941,1165,24.39%
Mental Health Therapy Coordinator,6718,9,5019,5963,944,18.81%
Mental Health Therapy Coordinator,6718,10,5256,5964,708,13.47%
Mental Health Therapy Technician,6710,1,3005,3913,908,30.22%
Mental Health Therapy Technician,6710,1,3005,3913,908,30.22%
Mental Health Therapy Technician,6710,2,3095,3849,754,24.36%
Mental Health Therapy Technician,6710,2,3095,3849,754,24.36%
Mental Health Therapy Technician,6710,3,3218,4002,784,24.36%
Mental Health Therapy Technician,6710,3,3218,4002,784,24.36%
Mental Health Therapy Technician,6710,4,3335,4148,813,24.38%
Mental Health Therapy Technician,6710,4,3335,4148,813,24.38%
Mental Health Therapy Technician,6710,5,3483,4332,849,24.38%
Mental Health Therapy Technician,6710,5,3483,4332,849,24.38%
Mental Health Therapy Technician,6710,6,3629,4514,885,24.39%
Mental Health Therapy Technician,6710,6,3629,4514,885,24.39%
Mental Health Therapy Technician,6710,7,3790,4714,924,24.38%
Mental Health Therapy Technician,6710,7,3790,4714,924,24.38%
Mental Health Therapy Technician,6710,8,3964,4930,966,24.37%
Mental Health Therapy Technician,6710,8,3964,4930,966,24.37%
Mental Health Therapy Technician,6710,9,4155,4936,781,18.80%
Mental Health Therapy Technician,6710,9,4155,4936,781,18.80%
Mental Health Therapy Technician,6710,10,4356,4943,587,13.48%
Mental Health Therapy Technician,6710,10,4356,4943,587,13.48%
Microbiologist 1,3779,1,4155,5168,1013,24.38%
Microbiologist 1,3779,2,4356,5418,1062,24.38%
Microbiologist 1,3779,3,4555,5666,1111,24.39%
Microbiologist 1,3779,4,4776,5941,1165,24.39%
Microbiologist 1,3779,5,5019,6243,1224,24.39%
Microbiologist 1,3779,6,5256,6538,1282,24.39%
Microbiologist 1,3779,7,5503,6845,1342,24.39%
Microbiologist 1,3779,8,5771,7178,1407,24.38%
Microbiologist 1,3779,9,6051,7189,1138,18.81%
Microbiologist 1,3779,10,6350,7205,855,13.46%
Microbiologist 2,3780,1,4555,5666,1111,24.39%
Microbiologist 2,3780,2,4776,5941,1165,24.39%
Microbiologist 2,3780,3,5019,6243,1224,24.39%
Microbiologist 2,3780,4,5256,6538,1282,24.39%
Microbiologist 2,3780,5,5503,6845,1342,24.39%
Microbiologist 2,3780,6,5771,7178,1407,24.38%
Microbiologist 2,3780,7,6051,7527,1476,24.39%
Microbiologist 2,3780,8,6350,7898,1548,24.38%
Microbiologist 2,3780,9,6664,7917,1253,18.80%
Microbiologist 2,3780,10,6982,7922,940,13.46%
Microbiologist 3,3781,1,5256,6538,1282,24.39%
Microbiologist 3,3781,2,5503,6845,1342,24.39%
Microbiologist 3,3781,3,5771,7178,1407,24.38%
Microbiologist 3,3781,4,6051,7527,1476,24.39%
Microbiologist 3,3781,5,6350,7898,1548,24.38%
Microbiologist 3,3781,6,6664,8289,1625,24.38%
Microbiologist 3,3781,7,6982,8685,1703,24.39%
Microbiologist 3,3781,8,7327,9114,1787,24.39%
Microbiologist 3,3781,9,7678,9122,1444,18.81%
Microbiologist 3,3781,10,8057,9142,1085,13.47%
Motor Carrier Enforcement Officer 1,5857,1,3790,4714,924,24.38%
Motor Carrier Enforcement Officer 1,5857,2,3964,4930,966,24.37%
Motor Carrier Enforcement Officer 1,5857,3,4155,5168,1013,24.38%
Motor Carrier Enforcement Officer 1,5857,4,4356,5418,1062,24.38%
Motor Carrier Enforcement Officer 1,5857,5,4555,5666,1111,24.39%
Motor Carrier Enforcement Officer 1,5857,6,4776,5941,1165,24.39%
Motor Carrier Enforcement Officer 1,5857,7,5019,6243,1224,24.39%
Motor Carrier Enforcement Officer 1,5857,8,5256,6538,1282,24.39%
Motor Carrier Enforcement Officer 1,5857,9,5503,6538,1035,18.81%
Motor Carrier Enforcement Officer 1,5857,10,5771,6548,777,13.46%
Motor Carrier Enforcement Officer 2,5858,1,4356,5418,1062,24.38%
Motor Carrier Enforcement Officer 2,5858,2,4555,5666,1111,24.39%
Motor Carrier Enforcement Officer 2,5858,3,4776,5941,1165,24.39%
Motor Carrier Enforcement Officer 2,5858,4,5019,6243,1224,24.39%
Motor Carrier Enforcement Officer 2,5858,5,5256,6538,1282,24.39%
Motor Carrier Enforcement Officer 2,5858,6,5503,6845,1342,24.39%
Motor Carrier Enforcement Officer 2,5858,7,5771,7178,1407,24.38%
Motor Carrier Enforcement Officer 2,5858,8,6051,7527,1476,24.39%
Motor Carrier Enforcement Officer 2,5858,9,6350,7544,1194,18.80%
Motor Carrier Enforcement Officer 2,5858,10,6664,7562,898,13.48%
Natural Resource Specialist 1,8501,1,3790,4714,924,24.38%
Natural Resource Specialist 1,8501,1,3790,4714,924,24.38%
Natural Resource Specialist 1,8501,2,3964,4930,966,24.37%
Natural Resource Specialist 1,8501,2,3964,4930,966,24.37%
Natural Resource Specialist 1,8501,3,4155,5168,1013,24.38%
Natural Resource Specialist 1,8501,3,4155,5168,1013,24.38%
Natural Resource Specialist 1,8501,4,4356,5418,1062,24.38%
Natural Resource Specialist 1,8501,4,4356,5418,1062,24.38%
Natural Resource Specialist 1,8501,5,4555,5666,1111,24.39%
Natural Resource Specialist 1,8501,5,4555,5666,1111,24.39%
Natural Resource Specialist 1,8501,6,4776,5941,1165,24.39%
Natural Resource Specialist 1,8501,6,4776,5941,1165,24.39%
Natural Resource Specialist 1,8501,7,5019,6243,1224,24.39%
Natural Resource Specialist 1,8501,7,5019,6243,1224,24.39%
Natural Resource Specialist 1,8501,8,5256,6538,1282,24.39%
Natural Resource Specialist 1,8501,8,5256,6538,1282,24.39%
Natural Resource Specialist 1,8501,9,5503,6538,1035,18.81%
Natural Resource Specialist 1,8501,9,5503,6538,1035,18.81%
Natural Resource Specialist 1,8501,10,5771,6548,777,13.46%
Natural Resource Specialist 1,8501,10,5771,6548,777,13.46%
Natural Resource Specialist 2,8503,1,4356,5418,1062,24.38%
Natural Resource Specialist 2,8503,1,4356,5418,1062,24.38%
Natural Resource Specialist 2,8503,2,4555,5666,1111,24.39%
Natural Resource Specialist 2,8503,2,4555,5666,1111,24.39%
Natural Resource Specialist 2,8503,3,4776,5941,1165,24.39%
Natural Resource Specialist 2,8503,3,4776,5941,1165,24.39%
Natural Resource Specialist 2,8503,4,5019,6243,1224,24.39%
Natural Resource Specialist 2,8503,4,5019,6243,1224,24.39%
Natural Resource Specialist 2,8503,5,5256,6538,1282,24.39%
Natural Resource Specialist 2,8503,5,5256,6538,1282,24.39%
Natural Resource Specialist 2,8503,6,5503,6845,1342,24.39%
Natural Resource Specialist 2,8503,6,5503,6845,1342,24.39%
Natural Resource Specialist 2,8503,7,5771,7178,1407,24.38%
Natural Resource Specialist 2,8503,7,5771,7178,1407,24.38%
Natural Resource Specialist 2,8503,8,6051,7527,1476,24.39%
Natural Resource Specialist 2,8503,8,6051,7527,1476,24.39%
Natural Resource Specialist 2,8503,9,6350,7544,1194,18.80%
Natural Resource Specialist 2,8503,9,6350,7544,1194,18.80%
Natural Resource Specialist 2,8503,10,6664,7562,898,13.48%
Natural Resource Specialist 2,8503,10,6664,7562,898,13.48%
Natural Resource Specialist 3,8503,1,5019,6243,1224,24.39%
Natural Resource Specialist 3,8503,1,5019,6243,1224,24.39%
Natural Resource Specialist 3,8503,2,5256,6538,1282,24.39%
Natural Resource Specialist 3,8503,2,5256,6538,1282,24.39%
Natural Resource Specialist 3,8503,3,5503,6845,1342,24.39%
Natural Resource Specialist 3,8503,3,5503,6845,1342,24.39%
Natural Resource Specialist 3,8503,4,5771,7178,1407,24.38%
Natural Resource Specialist 3,8503,4,5771,7178,1407,24.38%
Natural Resource Specialist 3,8503,5,6051,7527,1476,24.39%
Natural Resource Specialist 3,8503,5,6051,7527,1476,24.39%
Natural Resource Specialist 3,8503,6,6350,7898,1548,24.38%
Natural Resource Specialist 3,8503,6,6350,7898,1548,24.38%
Natural Resource Specialist 3,8503,7,6664,8289,1625,24.38%
Natural Resource Specialist 3,8503,7,6664,8289,1625,24.38%
Natural Resource Specialist 3,8503,8,6982,8685,1703,24.39%
Natural Resource Specialist 3,8503,8,6982,8685,1703,24.39%
Natural Resource Specialist 3,8503,9,7327,8705,1378,18.81%
Natural Resource Specialist 3,8503,9,7327,8705,1378,18.81%
Natural Resource Specialist 3,8503,10,7678,8712,1034,13.47%
Natural Resource Specialist 3,8503,10,7678,8712,1034,13.47%
Natural Resource Specialist 4,8504,1,5771,7178,1407,24.38%
Natural Resource Specialist 4,8504,1,5771,7178,1407,24.38%
Natural Resource Specialist 4,8504,2,6051,7527,1476,24.39%
Natural Resource Specialist 4,8504,2,6051,7527,1476,24.39%
Natural Resource Specialist 4,8504,3,6350,7898,1548,24.38%
Natural Resource Specialist 4,8504,3,6350,7898,1548,24.38%
Natural Resource Specialist 4,8504,4,6664,8289,1625,24.38%
Natural Resource Specialist 4,8504,4,6664,8289,1625,24.38%
Natural Resource Specialist 4,8504,5,6982,8685,1703,24.39%
Natural Resource Specialist 4,8504,5,6982,8685,1703,24.39%
Natural Resource Specialist 4,8504,6,7327,9114,1787,24.39%
Natural Resource Specialist 4,8504,6,7327,9114,1787,24.39%
Natural Resource Specialist 4,8504,7,7678,9550,1872,24.38%
Natural Resource Specialist 4,8504,7,7678,9550,1872,24.38%
Natural Resource Specialist 4,8504,8,8057,10022,1965,24.39%
Natural Resource Specialist 4,8504,8,8057,10022,1965,24.39%
Natural Resource Specialist 4,8504,9,8450,10039,1589,18.80%
Natural Resource Specialist 4,8504,9,8450,10039,1589,18.80%
Natural Resource Specialist 4,8504,10,8870,10065,1195,13.47%
Natural Resource Specialist 4,8504,10,8870,10065,1195,13.47%
Natural Resource Specialist 5,8505,1,6350,7898,1548,24.38%
Natural Resource Specialist 5,8505,1,6350,7898,1548,24.38%
Natural Resource Specialist 5,8505,2,6664,8289,1625,24.38%
Natural Resource Specialist 5,8505,2,6664,8289,1625,24.38%
Natural Resource Specialist 5,8505,3,6982,8685,1703,24.39%
Natural Resource Specialist 5,8505,3,6982,8685,1703,24.39%
Natural Resource Specialist 5,8505,4,7327,9114,1787,24.39%
Natural Resource Specialist 5,8505,4,7327,9114,1787,24.39%
Natural Resource Specialist 5,8505,5,7678,9550,1872,24.38%
Natural Resource Specialist 5,8505,5,7678,9550,1872,24.38%
Natural Resource Specialist 5,8505,6,8057,10022,1965,24.39%
Natural Resource Specialist 5,8505,6,8057,10022,1965,24.39%
Natural Resource Specialist 5,8505,7,8450,10511,2061,24.39%
Natural Resource Specialist 5,8505,7,8450,10511,2061,24.39%
Natural Resource Specialist 5,8505,8,8870,11033,2163,24.39%
Natural Resource Specialist 5,8505,8,8870,11033,2163,24.39%
Natural Resource Specialist 5,8505,9,9293,11040,1747,18.80%
Natural Resource Specialist 5,8505,9,9293,11040,1747,18.80%
Natural Resource Specialist 5,8505,10,9751,11065,1314,13.48%
Natural Resource Specialist 5,8505,10,9751,11065,1314,13.48%
Nutrition Consultant,5955,1,5503,6845,1342,24.39%
Nutrition Consultant,5955,2,5771,7178,1407,24.38%
Nutrition Consultant,5955,3,6051,7527,1476,24.39%
Nutrition Consultant,5955,4,6350,7898,1548,24.38%
Nutrition Consultant,5955,5,6664,8289,1625,24.38%
Nutrition Consultant,5955,6,6982,8685,1703,24.39%
Nutrition Consultant,5955,7,7327,9114,1787,24.39%
Nutrition Consultant,5955,8,7678,9550,1872,24.38%
Nutrition Consultant,5955,9,8057,9572,1515,18.80%
Nutrition Consultant,5955,10,8450,9588,1138,13.47%
Occupational Safety Specialist 1,5709,1,3964,4930,966,24.37%
Occupational Safety Specialist 1,5709,2,4155,5168,1013,24.38%
Occupational Safety Specialist 1,5709,3,4356,5418,1062,24.38%
Occupational Safety Specialist 1,5709,4,4555,5666,1111,24.39%
Occupational Safety Specialist 1,5709,5,4776,5941,1165,24.39%
Occupational Safety Specialist 1,5709,6,5019,6243,1224,24.39%
Occupational Safety Specialist 1,5709,7,5256,6538,1282,24.39%
Occupational Safety Specialist 1,5709,8,5503,6845,1342,24.39%
Occupational Safety Specialist 1,5709,9,5771,6856,1085,18.80%
Occupational Safety Specialist 1,5709,10,6051,6866,815,13.47%
Occupational Safety Specialist 2,5710,1,5019,6243,1224,24.39%
Occupational Safety Specialist 2,5710,2,5256,6538,1282,24.39%
Occupational Safety Specialist 2,5710,3,5503,6845,1342,24.39%
Occupational Safety Specialist 2,5710,4,5771,7178,1407,24.38%
Occupational Safety Specialist 2,5710,5,6051,7527,1476,24.39%
Occupational Safety Specialist 2,5710,6,6350,7898,1548,24.38%
Occupational Safety Specialist 2,5710,7,6664,8289,1625,24.38%
Occupational Safety Specialist 2,5710,8,6982,8685,1703,24.39%
Occupational Safety Specialist 2,5710,9,7327,8705,1378,18.81%
Occupational Safety Specialist 2,5710,10,7678,8712,1034,13.47%
Occupational Safety Specialist 3,5711,1,5503,6845,1342,24.39%
Occupational Safety Specialist 3,5711,2,5771,7178,1407,24.38%
Occupational Safety Specialist 3,5711,3,6051,7527,1476,24.39%
Occupational Safety Specialist 3,5711,4,6350,7898,1548,24.38%
Occupational Safety Specialist 3,5711,5,6664,8289,1625,24.38%
Occupational Safety Specialist 3,5711,6,6982,8685,1703,24.39%
Occupational Safety Specialist 3,5711,7,7327,9114,1787,24.39%
Occupational Safety Specialist 3,5711,8,7678,9550,1872,24.38%
Occupational Safety Specialist 3,5711,9,8057,9572,1515,18.80%
Occupational Safety Specialist 3,5711,10,8450,9588,1138,13.47%
Occupational Therapist,6508,1,6350,7898,1548,24.38%
Occupational Therapist,6508,2,6664,8289,1625,24.38%
Occupational Therapist,6508,3,6982,8685,1703,24.39%
Occupational Therapist,6508,4,7327,9114,1787,24.39%
Occupational Therapist,6508,5,7678,9550,1872,24.38%
Occupational Therapist,6508,6,8057,10022,1965,24.39%
Occupational Therapist,6508,7,8450,10511,2061,24.39%
Occupational Therapist,6508,8,8870,11033,2163,24.39%
Occupational Therapist,6508,9,9293,11040,1747,18.80%
Occupational Therapist,6508,10,9751,11065,1314,13.48%
Office Assistant 1,101,1,0,0,0,
Office Assistant 1,101,2,0,0,0,
Office Assistant 1,101,3,0,0,0,
Office Assistant 1,101,4,0,0,0,
Office Assistant 1,101,5,0,0,0,
Office Assistant 1,101,6,0,0,0,
Office Assistant 1,101,7,0,0,0,
Office Assistant 1,101,8,3005,3738,733,24.39%
Office Assistant 1,101,9,3095,3677,582,18.80%
Office Assistant 1,101,10,3218,3651,433,13.46%
Office Assistant 2,103,1,0,0,0,
Office Assistant 2,103,2,0,0,0,
Office Assistant 2,103,3,0,0,0,
Office Assistant 2,103,4,0,0,0,
Office Assistant 2,103,5,0,0,0,
Office Assistant 2,103,6,3005,3738,733,24.39%
Office Assistant 2,103,7,3095,3849,754,24.36%
Office Assistant 2,103,8,3218,4002,784,24.36%
Office Assistant 2,103,9,3335,3962,627,18.80%
Office Assistant 2,103,10,3483,3952,469,13.47%
Office Coordinator,801,1,3005,3738,733,24.39%
Office Coordinator,801,2,3095,3849,754,24.36%
Office Coordinator,801,3,3218,4002,784,24.36%
Office Coordinator,801,4,3335,4148,813,24.38%
Office Coordinator,801,5,3483,4332,849,24.38%
Office Coordinator,801,6,3629,4514,885,24.39%
Office Coordinator,801,7,3790,4714,924,24.38%
Office Coordinator,801,8,3964,4930,966,24.37%
Office Coordinator,801,9,4155,4936,781,18.80%
Office Coordinator,801,10,4356,4943,587,13.48%
Office Specialist 1,103,1,0,0,0,
Office Specialist 1,103,2,0,0,0,
Office Specialist 1,103,3,3005,3738,733,24.39%
Office Specialist 1,103,4,3095,3849,754,24.36%
Office Specialist 1,103,5,3218,4002,784,24.36%
Office Specialist 1,103,6,3335,4148,813,24.38%
Office Specialist 1,103,7,3483,4332,849,24.38%
Office Specialist 1,103,8,3629,4514,885,24.39%
Office Specialist 1,103,9,3790,4502,712,18.79%
Office Specialist 1,103,10,3964,4498,534,13.47%
Office Specialist 2,104,1,3005,3738,733,24.39%
Office Specialist 2,104,2,3095,3849,754,24.36%
Office Specialist 2,104,3,3218,4002,784,24.36%
Office Specialist 2,104,4,3335,4148,813,24.38%
Office Specialist 2,104,5,3483,4332,849,24.38%
Office Specialist 2,104,6,3629,4514,885,24.39%
Office Specialist 2,104,7,3790,4714,924,24.38%
Office Specialist 2,104,8,3964,4930,966,24.37%
Office Specialist 2,104,9,4155,4936,781,18.80%
Office Specialist 2,104,10,4356,4943,587,13.48%
Operations & Policy Analyst 1,870,1,4155,5168,1013,24.38%
Operations & Policy Analyst 1,870,2,4356,5418,1062,24.38%
Operations & Policy Analyst 1,870,3,4555,5666,1111,24.39%
Operations & Policy Analyst 1,870,4,4776,5941,1165,24.39%
Operations & Policy Analyst 1,870,5,5019,6243,1224,24.39%
Operations & Policy Analyst 1,870,6,5256,6538,1282,24.39%
Operations & Policy Analyst 1,870,7,5503,6845,1342,24.39%
Operations & Policy Analyst 1,870,8,5771,7178,1407,24.38%
Operations & Policy Analyst 1,870,9,6051,7189,1138,18.81%
Operations & Policy Analyst 1,870,10,6350,7205,855,13.46%
Operations & Policy Analyst 2,871,1,5019,6243,1224,24.39%
Operations & Policy Analyst 2,871,2,5256,6538,1282,24.39%
Operations & Policy Analyst 2,871,3,5503,6845,1342,24.39%
Operations & Policy Analyst 2,871,4,5771,7178,1407,24.38%
Operations & Policy Analyst 2,871,5,6051,7527,1476,24.39%
Operations & Policy Analyst 2,871,6,6350,7898,1548,24.38%
Operations & Policy Analyst 2,871,7,6664,8289,1625,24.38%
Operations & Policy Analyst 2,871,8,6982,8685,1703,24.39%
Operations & Policy Analyst 2,871,9,7327,8705,1378,18.81%
Operations & Policy Analyst 2,871,10,7678,8712,1034,13.47%
Operations & Policy Analyst 3,873,1,5771,7178,1407,24.38%
Operations & Policy Analyst 3,873,1,5771,7178,1407,24.38%
Operations & Policy Analyst 3,873,2,6051,7527,1476,24.39%
Operations & Policy Analyst 3,873,2,6051,7527,1476,24.39%
Operations & Policy Analyst 3,873,3,6350,7898,1548,24.38%
Operations & Policy Analyst 3,873,3,6350,7898,1548,24.38%
Operations & Policy Analyst 3,873,4,6664,8289,1625,24.38%
Operations & Policy Analyst 3,873,4,6664,8289,1625,24.38%
Operations & Policy Analyst 3,873,5,6982,8685,1703,24.39%
Operations & Policy Analyst 3,873,5,6982,8685,1703,24.39%
Operations & Policy Analyst 3,873,6,7327,9114,1787,24.39%
Operations & Policy Analyst 3,873,6,7327,9114,1787,24.39%
Operations & Policy Analyst 3,873,7,7678,9550,1872,24.38%
Operations & Policy Analyst 3,873,7,7678,9550,1872,24.38%
Operations & Policy Analyst 3,873,8,8057,10022,1965,24.39%
Operations & Policy Analyst 3,873,8,8057,10022,1965,24.39%
Operations & Policy Analyst 3,873,9,8450,10039,1589,18.80%
Operations & Policy Analyst 3,873,9,8450,10039,1589,18.80%
Operations & Policy Analyst 3,873,10,8870,10065,1195,13.47%
Operations & Policy Analyst 3,873,10,8870,10065,1195,13.47%
Operations & Policy Analyst 4,873,1,6350,7898,1548,24.38%
Operations & Policy Analyst 4,873,2,6664,8289,1625,24.38%
Operations & Policy Analyst 4,873,3,6982,8685,1703,24.39%
Operations & Policy Analyst 4,873,4,7327,9114,1787,24.39%
Operations & Policy Analyst 4,873,5,7678,9550,1872,24.38%
Operations & Policy Analyst 4,873,6,8057,10022,1965,24.39%
Operations & Policy Analyst 4,873,7,8450,10511,2061,24.39%
Operations & Policy Analyst 4,873,8,8870,11033,2163,24.39%
Operations & Policy Analyst 4,873,9,9293,11040,1747,18.80%
Operations & Policy Analyst 4,873,10,9751,11065,1314,13.48%
Painter,4001,1,3964,4930,966,24.37%
Painter,4001,2,4155,5168,1013,24.38%
Painter,4001,3,4356,5418,1062,24.38%
Painter,4001,4,4555,5666,1111,24.39%
Painter,4001,5,4776,5941,1165,24.39%
Painter,4001,6,5019,6243,1224,24.39%
Painter,4001,7,5256,6538,1282,24.39%
Painter,4001,8,5503,6845,1342,24.39%
Painter,4001,9,5771,6856,1085,18.80%
Painter,4001,10,6051,6866,815,13.47%
Paralegal,1534,1,4776,5941,1165,24.39%
Paralegal,1534,2,5019,6243,1224,24.39%
Paralegal,1534,3,5256,6538,1282,24.39%
Paralegal,1534,4,5503,6845,1342,24.39%
Paralegal,1534,5,5771,7178,1407,24.38%
Paralegal,1534,6,6051,7527,1476,24.39%
Paralegal,1534,7,6350,7898,1548,24.38%
Paralegal,1534,8,6664,8289,1625,24.38%
Paralegal,1534,9,6982,8295,1313,18.81%
Paralegal,1534,10,7327,8314,987,13.47%
Park Ranger 1,8434,1,0,0,0,
Park Ranger 1,8434,1,0,0,0,
Park Ranger 1,8434,2,3483,4332,849,24.38%
Park Ranger 1,8434,2,3483,4332,849,24.38%
Park Ranger 1,8434,3,3629,4514,885,24.39%
Park Ranger 1,8434,3,3629,4514,885,24.39%
Park Ranger 1,8434,4,3790,4714,924,24.38%
Park Ranger 1,8434,4,3790,4714,924,24.38%
Park Ranger 1,8434,5,3964,4930,966,24.37%
Park Ranger 1,8434,5,3964,4930,966,24.37%
Park Ranger 1,8434,6,4155,5168,1013,24.38%
Park Ranger 1,8434,6,4155,5168,1013,24.38%
Park Ranger 1,8434,7,4356,5418,1062,24.38%
Park Ranger 1,8434,7,4356,5418,1062,24.38%
Park Ranger 1,8434,8,4555,5666,1111,24.39%
Park Ranger 1,8434,8,4555,5666,1111,24.39%
Park Ranger 1,8434,9,4776,5674,898,18.80%
Park Ranger 1,8434,9,4776,5674,898,18.80%
Park Ranger 1,8434,10,5007,5681,674,13.46%
Park Ranger 1,8434,10,5007,5681,674,13.46%
Park Ranger 2,8435,1,3629,4514,885,24.39%
Park Ranger 2,8435,2,3790,4714,924,24.38%
Park Ranger 2,8435,3,3964,4930,966,24.37%
Park Ranger 2,8435,4,4155,5168,1013,24.38%
Park Ranger 2,8435,5,4356,5418,1062,24.38%
Park Ranger 2,8435,6,4555,5666,1111,24.39%
Park Ranger 2,8435,7,4776,5941,1165,24.39%
Park Ranger 2,8435,8,5019,6243,1224,24.39%
Park Ranger 2,8435,9,5256,6244,988,18.80%
Park Ranger 2,8435,10,5503,6244,741,13.47%
Park Ranger 3,8436,1,3964,4930,966,24.37%
Park Ranger 3,8436,2,4155,5168,1013,24.38%
Park Ranger 3,8436,3,4356,5418,1062,24.38%
Park Ranger 3,8436,4,4555,5666,1111,24.39%
Park Ranger 3,8436,5,4776,5941,1165,24.39%
Park Ranger 3,8436,6,5019,6243,1224,24.39%
Park Ranger 3,8436,7,5256,6538,1282,24.39%
Park Ranger 3,8436,8,5503,6845,1342,24.39%
Park Ranger 3,8436,9,5771,6856,1085,18.80%
Park Ranger 3,8436,10,6051,6866,815,13.47%
Park Ranger Assistant,8433,1,0,0,0,
Park Ranger Assistant,8433,2,0,0,0,
Park Ranger Assistant,8433,3,0,0,0,
Park Ranger Assistant,8433,4,3005,3738,733,24.39%
Park Ranger Assistant,8433,5,3095,3849,754,24.36%
Park Ranger Assistant,8433,6,3218,4002,784,24.36%
Park Ranger Assistant,8433,7,3335,4148,813,24.38%
Park Ranger Assistant,8433,8,3483,4332,849,24.38%
Park Ranger Assistant,8433,9,3629,4311,682,18.79%
Park Ranger Assistant,8433,10,3790,4300,510,13.46%
Park Specialist,8445,1,3218,4002,784,24.36%
Park Specialist,8445,2,3335,4148,813,24.38%
Park Specialist,8445,3,3483,4332,849,24.38%
Park Specialist,8445,4,3629,4514,885,24.39%
Park Specialist,8445,5,3790,4714,924,24.38%
Park Specialist,8445,6,3964,4930,966,24.37%
Park Specialist,8445,7,4155,5168,1013,24.38%
Park Specialist,8445,8,4356,5418,1062,24.38%
Park Specialist,8445,9,4555,5411,856,18.79%
Park Specialist,8445,10,4776,5419,643,13.46%
Parking Services Representative,5550,1,0,0,0,
Parking Services Representative,5550,2,3005,3738,733,24.39%
Parking Services Representative,5550,3,3095,3849,754,24.36%
Parking Services Representative,5550,4,3218,4002,784,24.36%
Parking Services Representative,5550,5,3335,4148,813,24.38%
Parking Services Representative,5550,6,3483,4332,849,24.38%
Parking Services Representative,5550,7,3629,4514,885,24.39%
Parking Services Representative,5550,8,3790,4714,924,24.38%
Parking Services Representative,5550,9,3964,4709,745,18.79%
Parking Services Representative,5550,10,4155,4714,559,13.45%
Parts Specialist 2,783,1,3629,4514,885,24.39%
Parts Specialist 2,783,2,3790,4714,924,24.38%
Parts Specialist 2,783,3,3964,4930,966,24.37%
Parts Specialist 2,783,4,4155,5168,1013,24.38%
Parts Specialist 2,783,5,4356,5418,1062,24.38%
Parts Specialist 2,783,6,4555,5666,1111,24.39%
Parts Specialist 2,783,7,4776,5941,1165,24.39%
Parts Specialist 2,783,8,5019,6243,1224,24.39%
Parts Specialist 2,783,9,5256,6244,988,18.80%
Parts Specialist 2,783,10,5503,6244,741,13.47%
Payroll Analyst,314,1,3790,4714,924,24.38%
Payroll Analyst,314,2,3964,4930,966,24.37%
Payroll Analyst,314,3,4155,5168,1013,24.38%
Payroll Analyst,314,4,4356,5418,1062,24.38%
Payroll Analyst,314,5,4555,5666,1111,24.39%
Payroll Analyst,314,6,4776,5941,1165,24.39%
Payroll Analyst,314,7,5019,6243,1224,24.39%
Payroll Analyst,314,8,5256,6538,1282,24.39%
Payroll Analyst,314,9,5503,6538,1035,18.81%
Payroll Analyst,314,10,5771,6548,777,13.46%
Pharmacist,6360,1,8870,11033,2163,24.39%
Pharmacist,6360,2,9293,11559,2266,24.38%
Pharmacist,6360,3,9751,12129,2378,24.39%
Pharmacist,6360,4,10242,12740,2498,24.39%
Pharmacist,6360,5,10740,13359,2619,24.39%
Pharmacist,6360,6,11267,14015,2748,24.39%
Pharmacist,6360,7,11825,14709,2884,24.39%
Pharmacist,6360,8,12408,15434,3026,24.39%
Pharmacist,6360,9,13020,15468,2448,18.80%
Pharmacist,6360,10,13662,15503,1841,13.48%
Pharmacist 2,6363,1,9751,12129,2378,24.39%
Pharmacist 2,6363,2,10242,12740,2498,24.39%
Pharmacist 2,6363,3,10740,13359,2619,24.39%
Pharmacist 2,6363,4,11267,14015,2748,24.39%
Pharmacist 2,6363,5,11825,14709,2884,24.39%
Pharmacist 2,6363,6,12408,15434,3026,24.39%
Pharmacist 2,6363,7,13020,16195,3175,24.39%
Pharmacist 2,6363,8,13662,16994,3332,24.39%
Pharmacist 2,6363,9,14337,17033,2696,18.80%
Pharmacist 2,6363,10,15046,17073,2027,13.47%
Pharmacist Resident,6361,1,4155,5168,1013,24.38%
Pharmacist Resident,6361,2,4356,5418,1062,24.38%
Pharmacist Resident,6361,3,4555,5666,1111,24.39%
Pharmacist Resident,6361,4,4776,5941,1165,24.39%
Pharmacist Resident,6361,5,5019,6243,1224,24.39%
Pharmacist Resident,6361,6,5256,6538,1282,24.39%
Pharmacist Resident,6361,7,5503,6845,1342,24.39%
Pharmacist Resident,6361,8,5771,7178,1407,24.38%
Pharmacist Resident,6361,9,6051,7189,1138,18.81%
Pharmacist Resident,6361,10,6350,7205,855,13.46%
Pharmacy Clerk & Technician 2,6388,1,3095,4030,935,30.21%
Pharmacy Clerk & Technician 2,6388,2,3218,4002,784,24.36%
Pharmacy Clerk & Technician 2,6388,3,3335,4148,813,24.38%
Pharmacy Clerk & Technician 2,6388,4,3483,4332,849,24.38%
Pharmacy Clerk & Technician 2,6388,5,3629,4514,885,24.39%
Pharmacy Clerk & Technician 2,6388,6,3790,4714,924,24.38%
Pharmacy Clerk & Technician 2,6388,7,3964,4930,966,24.37%
Pharmacy Clerk & Technician 2,6388,8,4155,5168,1013,24.38%
Pharmacy Clerk & Technician 2,6388,9,4356,5175,819,18.80%
Pharmacy Clerk & Technician 2,6388,10,4555,5168,613,13.46%
Pharmacy Clerk & Technician 3,6389,1,3218,4191,973,30.24%
Pharmacy Clerk & Technician 3,6389,2,3335,4148,813,24.38%
Pharmacy Clerk & Technician 3,6389,3,3483,4332,849,24.38%
Pharmacy Clerk & Technician 3,6389,4,3629,4514,885,24.39%
Pharmacy Clerk & Technician 3,6389,5,3790,4714,924,24.38%
Pharmacy Clerk & Technician 3,6389,6,3964,4930,966,24.37%
Pharmacy Clerk & Technician 3,6389,7,4155,5168,1013,24.38%
Pharmacy Clerk & Technician 3,6389,8,4356,5418,1062,24.38%
Pharmacy Clerk & Technician 3,6389,9,4555,5411,856,18.79%
Pharmacy Clerk & Technician 3,6389,10,4776,5419,643,13.46%
Physical Therapist,6503,1,6051,7527,1476,24.39%
Physical Therapist,6503,2,6350,7898,1548,24.38%
Physical Therapist,6503,3,6664,8289,1625,24.38%
Physical Therapist,6503,4,6982,8685,1703,24.39%
Physical Therapist,6503,5,7327,9114,1787,24.39%
Physical Therapist,6503,6,7678,9550,1872,24.38%
Physical Therapist,6503,7,8057,10022,1965,24.39%
Physical Therapist,6503,8,8450,10511,2061,24.39%
Physical Therapist,6503,9,8870,10538,1668,18.80%
Physical Therapist,6503,10,9293,10545,1252,13.47%
Physical/Electronic Security Technician,4037,1,3629,4514,885,24.39%
Physical/Electronic Security Technician,4037,2,3790,4714,924,24.38%
Physical/Electronic Security Technician,4037,3,3964,4930,966,24.37%
Physical/Electronic Security Technician,4037,4,4155,5168,1013,24.38%
Physical/Electronic Security Technician,4037,5,4356,5418,1062,24.38%
Physical/Electronic Security Technician,4037,6,4555,5666,1111,24.39%
Physical/Electronic Security Technician,4037,7,4776,5941,1165,24.39%
Physical/Electronic Security Technician,4037,8,5019,6243,1224,24.39%
Physical/Electronic Security Technician,4037,9,5256,6244,988,18.80%
Physical/Electronic Security Technician,4037,10,5503,6244,741,13.47%
Physical/Electronic Security Technician 3,4039,1,4356,5418,1062,24.38%
Physical/Electronic Security Technician 3,4039,2,4555,5666,1111,24.39%
Physical/Electronic Security Technician 3,4039,3,4776,5941,1165,24.39%
Physical/Electronic Security Technician 3,4039,4,5019,6243,1224,24.39%
Physical/Electronic Security Technician 3,4039,5,5256,6538,1282,24.39%
Physical/Electronic Security Technician 3,4039,6,5503,6845,1342,24.39%
Physical/Electronic Security Technician 3,4039,7,5771,7178,1407,24.38%
Physical/Electronic Security Technician 3,4039,8,6051,7527,1476,24.39%
Physical/Electronic Security Technician 3,4039,9,6350,7544,1194,18.80%
Physical/Electronic Security Technician 3,4039,10,6664,7562,898,13.48%
Physician's Assistant,6357,1,6664,8289,1625,24.38%
Physician's Assistant,6357,2,6982,8685,1703,24.39%
Physician's Assistant,6357,3,7327,9114,1787,24.39%
Physician's Assistant,6357,4,7678,9550,1872,24.38%
Physician's Assistant,6357,5,8057,10022,1965,24.39%
Physician's Assistant,6357,6,8450,10511,2061,24.39%
Physician's Assistant,6357,7,8870,11033,2163,24.39%
Physician's Assistant,6357,8,9293,11559,2266,24.38%
Physician's Assistant,6357,9,9751,11585,1834,18.81%
Physician's Assistant,6357,10,10242,11622,1380,13.47%
Planner 2,1097,1,5019,6243,1224,24.39%
Planner 2,1097,2,5256,6538,1282,24.39%
Planner 2,1097,3,5503,6845,1342,24.39%
Planner 2,1097,4,5771,7178,1407,24.38%
Planner 2,1097,5,6051,7527,1476,24.39%
Planner 2,1097,6,6350,7898,1548,24.38%
Planner 2,1097,7,6664,8289,1625,24.38%
Planner 2,1097,8,6982,8685,1703,24.39%
Planner 2,1097,9,7327,8705,1378,18.81%
Planner 2,1097,10,7678,8712,1034,13.47%
Plumber,4005,1,4356,5418,1062,24.38%
Plumber,4005,2,4555,5666,1111,24.39%
Plumber,4005,3,4776,5941,1165,24.39%
Plumber,4005,4,5019,6243,1224,24.39%
Plumber,4005,5,5256,6538,1282,24.39%
Plumber,4005,6,5503,6845,1342,24.39%
Plumber,4005,7,5771,7178,1407,24.38%
Plumber,4005,8,6051,7527,1476,24.39%
Plumber,4005,9,6350,7544,1194,18.80%
Plumber,4005,10,6664,7562,898,13.48%
Preadmissions Screening Specialist,6684,1,4356,5418,1062,24.38%
Preadmissions Screening Specialist,6684,2,4555,5666,1111,24.39%
Preadmissions Screening Specialist,6684,3,4776,5941,1165,24.39%
Preadmissions Screening Specialist,6684,4,5019,6243,1224,24.39%
Preadmissions Screening Specialist,6684,5,5256,6538,1282,24.39%
Preadmissions Screening Specialist,6684,6,5503,6845,1342,24.39%
Preadmissions Screening Specialist,6684,7,5771,7178,1407,24.38%
Preadmissions Screening Specialist,6684,8,6051,7527,1476,24.39%
Preadmissions Screening Specialist,6684,9,6350,7544,1194,18.80%
Preadmissions Screening Specialist,6684,10,6664,7562,898,13.48%
Print Services Technician,3446,1,3095,3849,754,24.36%
Print Services Technician,3446,2,3218,4002,784,24.36%
Print Services Technician,3446,3,3335,4148,813,24.38%
Print Services Technician,3446,4,3483,4332,849,24.38%
Print Services Technician,3446,5,3629,4514,885,24.39%
Print Services Technician,3446,6,3790,4714,924,24.38%
Print Services Technician,3446,7,3964,4930,966,24.37%
Print Services Technician,3446,8,4155,5168,1013,24.38%
Print Services Technician,3446,9,4356,5175,819,18.80%
Print Services Technician,3446,10,4555,5168,613,13.46%
Printing Production Coordinator,3475,1,4155,5168,1013,24.38%
Printing Production Coordinator,3475,2,4356,5418,1062,24.38%
Printing Production Coordinator,3475,3,4555,5666,1111,24.39%
Printing Production Coordinator,3475,4,4776,5941,1165,24.39%
Printing Production Coordinator,3475,5,5019,6243,1224,24.39%
Printing Production Coordinator,3475,6,5256,6538,1282,24.39%
Printing Production Coordinator,3475,7,5503,6845,1342,24.39%
Printing Production Coordinator,3475,8,5771,7178,1407,24.38%
Printing Production Coordinator,3475,9,6051,7189,1138,18.81%
Printing Production Coordinator,3475,10,6350,7205,855,13.46%
Procurement & Contract Specialist 1,436,1,4155,5168,1013,24.38%
Procurement & Contract Specialist 1,436,1,4155,5168,1013,24.38%
Procurement & Contract Specialist 1,436,2,4356,5418,1062,24.38%
Procurement & Contract Specialist 1,436,2,4356,5418,1062,24.38%
Procurement & Contract Specialist 1,436,3,4555,5666,1111,24.39%
Procurement & Contract Specialist 1,436,3,4555,5666,1111,24.39%
Procurement & Contract Specialist 1,436,4,4776,5941,1165,24.39%
Procurement & Contract Specialist 1,436,4,4776,5941,1165,24.39%
Procurement & Contract Specialist 1,436,5,5019,6243,1224,24.39%
Procurement & Contract Specialist 1,436,5,5019,6243,1224,24.39%
Procurement & Contract Specialist 1,436,6,5256,6538,1282,24.39%
Procurement & Contract Specialist 1,436,6,5256,6538,1282,24.39%
Procurement & Contract Specialist 1,436,7,5503,6845,1342,24.39%
Procurement & Contract Specialist 1,436,7,5503,6845,1342,24.39%
Procurement & Contract Specialist 1,436,8,5771,7178,1407,24.38%
Procurement & Contract Specialist 1,436,8,5771,7178,1407,24.38%
Procurement & Contract Specialist 1,436,9,6051,7189,1138,18.81%
Procurement & Contract Specialist 1,436,9,6051,7189,1138,18.81%
Procurement & Contract Specialist 1,436,10,6350,7205,855,13.46%
Procurement & Contract Specialist 1,436,10,6350,7205,855,13.46%
Procurement & Contract Specialist 2,437,1,5019,6243,1224,24.39%
Procurement & Contract Specialist 2,437,2,5256,6538,1282,24.39%
Procurement & Contract Specialist 2,437,3,5503,6845,1342,24.39%
Procurement & Contract Specialist 2,437,4,5771,7178,1407,24.38%
Procurement & Contract Specialist 2,437,5,6051,7527,1476,24.39%
Procurement & Contract Specialist 2,437,6,6350,7898,1548,24.38%
Procurement & Contract Specialist 2,437,7,6664,8289,1625,24.38%
Procurement & Contract Specialist 2,437,8,6982,8685,1703,24.39%
Procurement & Contract Specialist 2,437,9,7327,8705,1378,18.81%
Procurement & Contract Specialist 2,437,10,7678,8712,1034,13.47%
Procurement & Contract Specialist 3,438,1,5503,6845,1342,24.39%
Procurement & Contract Specialist 3,438,2,5771,7178,1407,24.38%
Procurement & Contract Specialist 3,438,3,6051,7527,1476,24.39%
Procurement & Contract Specialist 3,438,4,6350,7898,1548,24.38%
Procurement & Contract Specialist 3,438,5,6664,8289,1625,24.38%
Procurement & Contract Specialist 3,438,6,6982,8685,1703,24.39%
Procurement & Contract Specialist 3,438,7,7327,9114,1787,24.39%
Procurement & Contract Specialist 3,438,8,7678,9550,1872,24.38%
Procurement & Contract Specialist 3,438,9,8057,9572,1515,18.80%
Procurement & Contract Specialist 3,438,10,8450,9588,1138,13.47%
Procurement And Contract Assistant,435,1,3483,4332,849,24.38%
Procurement And Contract Assistant,435,2,3629,4514,885,24.39%
Procurement And Contract Assistant,435,3,3790,4714,924,24.38%
Procurement And Contract Assistant,435,4,3964,4930,966,24.37%
Procurement And Contract Assistant,435,5,4155,5168,1013,24.38%
Procurement And Contract Assistant,435,6,4356,5418,1062,24.38%
Procurement And Contract Assistant,435,7,4555,5666,1111,24.39%
Procurement And Contract Assistant,435,8,4776,5941,1165,24.39%
Procurement And Contract Assistant,435,9,5019,5963,944,18.81%
Procurement And Contract Assistant,435,10,5256,5964,708,13.47%
Program Analyst 1,860,1,4155,5168,1013,24.38%
Program Analyst 1,860,2,4356,5418,1062,24.38%
Program Analyst 1,860,3,4555,5666,1111,24.39%
Program Analyst 1,860,4,4776,5941,1165,24.39%
Program Analyst 1,860,5,5019,6243,1224,24.39%
Program Analyst 1,860,6,5256,6538,1282,24.39%
Program Analyst 1,860,7,5503,6845,1342,24.39%
Program Analyst 1,860,8,5771,7178,1407,24.38%
Program Analyst 1,860,9,6051,7189,1138,18.81%
Program Analyst 1,860,10,6350,7205,855,13.46%
Program Analyst 2,861,1,5019,6243,1224,24.39%
Program Analyst 2,861,2,5256,6538,1282,24.39%
Program Analyst 2,861,3,5503,6845,1342,24.39%
Program Analyst 2,861,4,5771,7178,1407,24.38%
Program Analyst 2,861,5,6051,7527,1476,24.39%
Program Analyst 2,861,6,6350,7898,1548,24.38%
Program Analyst 2,861,7,6664,8289,1625,24.38%
Program Analyst 2,861,8,6982,8685,1703,24.39%
Program Analyst 2,861,9,7327,8705,1378,18.81%
Program Analyst 2,861,10,7678,8712,1034,13.47%
Program Analyst 3,863,1,5503,6845,1342,24.39%
Program Analyst 3,863,2,5771,7178,1407,24.38%
Program Analyst 3,863,3,6051,7527,1476,24.39%
Program Analyst 3,863,4,6350,7898,1548,24.38%
Program Analyst 3,863,5,6664,8289,1625,24.38%
Program Analyst 3,863,6,6982,8685,1703,24.39%
Program Analyst 3,863,7,7327,9114,1787,24.39%
Program Analyst 3,863,8,7678,9550,1872,24.38%
Program Analyst 3,863,9,8057,9572,1515,18.80%
Program Analyst 3,863,10,8450,9588,1138,13.47%
Program Analyst 4,863,1,6051,7527,1476,24.39%
Program Analyst 4,863,2,6350,7898,1548,24.38%
Program Analyst 4,863,3,6664,8289,1625,24.38%
Program Analyst 4,863,4,6982,8685,1703,24.39%
Program Analyst 4,863,5,7327,9114,1787,24.39%
Program Analyst 4,863,6,7678,9550,1872,24.38%
Program Analyst 4,863,7,8057,10022,1965,24.39%
Program Analyst 4,863,8,8450,10511,2061,24.39%
Program Analyst 4,863,9,8870,10538,1668,18.80%
Program Analyst 4,863,10,9293,10545,1252,13.47%
Project Manager 1,854,1,5019,6243,1224,24.39%
Project Manager 1,854,2,5256,6538,1282,24.39%
Project Manager 1,854,3,5503,6845,1342,24.39%
Project Manager 1,854,4,5771,7178,1407,24.38%
Project Manager 1,854,5,6051,7527,1476,24.39%
Project Manager 1,854,6,6350,7898,1548,24.38%
Project Manager 1,854,7,6664,8289,1625,24.38%
Project Manager 1,854,8,6982,8685,1703,24.39%
Project Manager 1,854,9,7327,8705,1378,18.81%
Project Manager 1,854,10,7678,8712,1034,13.47%
Project Manager 2,855,1,5771,7178,1407,24.38%
Project Manager 2,855,2,6051,7527,1476,24.39%
Project Manager 2,855,3,6350,7898,1548,24.38%
Project Manager 2,855,4,6664,8289,1625,24.38%
Project Manager 2,855,5,6982,8685,1703,24.39%
Project Manager 2,855,6,7327,9114,1787,24.39%
Project Manager 2,855,7,7678,9550,1872,24.38%
Project Manager 2,855,8,8057,10022,1965,24.39%
Project Manager 2,855,9,8450,10039,1589,18.80%
Project Manager 2,855,10,8870,10065,1195,13.47%
Project Manager 3,856,1,6350,7898,1548,24.38%
Project Manager 3,856,2,6664,8289,1625,24.38%
Project Manager 3,856,3,6982,8685,1703,24.39%
Project Manager 3,856,4,7327,9114,1787,24.39%
Project Manager 3,856,5,7678,9550,1872,24.38%
Project Manager 3,856,6,8057,10022,1965,24.39%
Project Manager 3,856,7,8450,10511,2061,24.39%
Project Manager 3,856,8,8870,11033,2163,24.39%
Project Manager 3,856,9,9293,11040,1747,18.80%
Project Manager 3,856,10,9751,11065,1314,13.48%
Psychiatric Social Worker,6730,1,5503,6845,1342,24.39%
Psychiatric Social Worker,6730,2,5771,7178,1407,24.38%
Psychiatric Social Worker,6730,3,6051,7527,1476,24.39%
Psychiatric Social Worker,6730,4,6350,7898,1548,24.38%
Psychiatric Social Worker,6730,5,6664,8289,1625,24.38%
Psychiatric Social Worker,6730,6,6982,8685,1703,24.39%
Psychiatric Social Worker,6730,7,7327,9114,1787,24.39%
Psychiatric Social Worker,6730,8,7678,9550,1872,24.38%
Psychiatric Social Worker,6730,9,8057,9572,1515,18.80%
Psychiatric Social Worker,6730,10,8450,9588,1138,13.47%
Public Affairs Specialist 1,864,1,4555,5666,1111,24.39%
Public Affairs Specialist 1,864,1,4555,5666,1111,24.39%
Public Affairs Specialist 1,864,2,4776,5941,1165,24.39%
Public Affairs Specialist 1,864,2,4776,5941,1165,24.39%
Public Affairs Specialist 1,864,3,5019,6243,1224,24.39%
Public Affairs Specialist 1,864,3,5019,6243,1224,24.39%
Public Affairs Specialist 1,864,4,5256,6538,1282,24.39%
Public Affairs Specialist 1,864,4,5256,6538,1282,24.39%
Public Affairs Specialist 1,864,5,5503,6845,1342,24.39%
Public Affairs Specialist 1,864,5,5503,6845,1342,24.39%
Public Affairs Specialist 1,864,6,5771,7178,1407,24.38%
Public Affairs Specialist 1,864,6,5771,7178,1407,24.38%
Public Affairs Specialist 1,864,7,6051,7527,1476,24.39%
Public Affairs Specialist 1,864,7,6051,7527,1476,24.39%
Public Affairs Specialist 1,864,8,6350,7898,1548,24.38%
Public Affairs Specialist 1,864,8,6350,7898,1548,24.38%
Public Affairs Specialist 1,864,9,6664,7917,1253,18.80%
Public Affairs Specialist 1,864,9,6664,7917,1253,18.80%
Public Affairs Specialist 1,864,10,6982,7922,940,13.46%
Public Affairs Specialist 1,864,10,6982,7922,940,13.46%
Public Affairs Specialist 2,865,1,5503,6845,1342,24.39%
Public Affairs Specialist 2,865,2,5771,7178,1407,24.38%
Public Affairs Specialist 2,865,3,6051,7527,1476,24.39%
Public Affairs Specialist 2,865,4,6350,7898,1548,24.38%
Public Affairs Specialist 2,865,5,6664,8289,1625,24.38%
Public Affairs Specialist 2,865,6,6982,8685,1703,24.39%
Public Affairs Specialist 2,865,7,7327,9114,1787,24.39%
Public Affairs Specialist 2,865,8,7678,9550,1872,24.38%
Public Affairs Specialist 2,865,9,8057,9572,1515,18.80%
Public Affairs Specialist 2,865,10,8450,9588,1138,13.47%
Public Affairs Specialist 3,866,1,6051,7527,1476,24.39%
Public Affairs Specialist 3,866,2,6350,7898,1548,24.38%
Public Affairs Specialist 3,866,3,6664,8289,1625,24.38%
Public Affairs Specialist 3,866,4,6982,8685,1703,24.39%
Public Affairs Specialist 3,866,5,7327,9114,1787,24.39%
Public Affairs Specialist 3,866,6,7678,9550,1872,24.38%
Public Affairs Specialist 3,866,7,8057,10022,1965,24.39%
Public Affairs Specialist 3,866,8,8450,10511,2061,24.39%
Public Affairs Specialist 3,866,9,8870,10538,1668,18.80%
Public Affairs Specialist 3,866,10,9293,10545,1252,13.47%
Public Health Educator 1,3337,1,4356,5418,1062,24.38%
Public Health Educator 1,3337,2,4555,5666,1111,24.39%
Public Health Educator 1,3337,3,4776,5941,1165,24.39%
Public Health Educator 1,3337,4,5019,6243,1224,24.39%
Public Health Educator 1,3337,5,5256,6538,1282,24.39%
Public Health Educator 1,3337,6,5503,6845,1342,24.39%
Public Health Educator 1,3337,7,5771,7178,1407,24.38%
Public Health Educator 1,3337,8,6051,7527,1476,24.39%
Public Health Educator 1,3337,9,6350,7544,1194,18.80%
Public Health Educator 1,3337,10,6664,7562,898,13.48%
Public Health Educator 2,3338,1,4776,5941,1165,24.39%
Public Health Educator 2,3338,2,5019,6243,1224,24.39%
Public Health Educator 2,3338,3,5256,6538,1282,24.39%
Public Health Educator 2,3338,4,5503,6845,1342,24.39%
Public Health Educator 2,3338,5,5771,7178,1407,24.38%
Public Health Educator 2,3338,6,6051,7527,1476,24.39%
Public Health Educator 2,3338,7,6350,7898,1548,24.38%
Public Health Educator 2,3338,8,6664,8289,1625,24.38%
Public Health Educator 2,3338,9,6982,8295,1313,18.81%
Public Health Educator 2,3338,10,7327,8314,987,13.47%
Public Health Nurse 2,6339,1,6756,8404,1648,24.39%
Public Health Nurse 2,6339,2,7074,8799,1725,24.39%
Public Health Nurse 2,6339,3,7410,9217,1807,24.39%
Public Health Nurse 2,6339,4,7764,9657,1893,24.38%
Public Health Nurse 2,6339,5,8130,10113,1983,24.39%
Public Health Nurse 2,6339,6,8519,10597,2078,24.39%
Public Health Nurse 2,6339,7,8964,11150,2186,24.39%
Public Health Nurse 2,6339,8,9345,11624,2279,24.39%
Public Health Nurse 2,6339,9,9789,11630,1841,18.81%
Public Health Nurse 2,6339,10,10254,11635,1381,13.47%
Public Health Toxicologist 1,3433,1,5503,6845,1342,24.39%
Public Health Toxicologist 1,3433,2,5771,7178,1407,24.38%
Public Health Toxicologist 1,3433,3,6051,7527,1476,24.39%
Public Health Toxicologist 1,3433,4,6350,7898,1548,24.38%
Public Health Toxicologist 1,3433,5,6664,8289,1625,24.38%
Public Health Toxicologist 1,3433,6,6982,8685,1703,24.39%
Public Health Toxicologist 1,3433,7,7327,9114,1787,24.39%
Public Health Toxicologist 1,3433,8,7678,9550,1872,24.38%
Public Health Toxicologist 1,3433,9,8057,9572,1515,18.80%
Public Health Toxicologist 1,3433,10,8450,9588,1138,13.47%
Public Service Representative 2,333,1,0,0,0,
Public Service Representative 2,333,2,0,0,0,
Public Service Representative 2,333,3,3005,3738,733,24.39%
Public Service Representative 2,333,4,3095,3849,754,24.36%
Public Service Representative 2,333,5,3218,4002,784,24.36%
Public Service Representative 2,333,6,3335,4148,813,24.38%
Public Service Representative 2,333,7,3483,4332,849,24.38%
Public Service Representative 2,333,8,3629,4514,885,24.39%
Public Service Representative 2,333,9,3790,4502,712,18.79%
Public Service Representative 2,333,10,3964,4498,534,13.47%
Public Service Representative 3,333,1,3005,3738,733,24.39%
Public Service Representative 3,333,2,3095,3849,754,24.36%
Public Service Representative 3,333,3,3218,4002,784,24.36%
Public Service Representative 3,333,4,3335,4148,813,24.38%
Public Service Representative 3,333,5,3483,4332,849,24.38%
Public Service Representative 3,333,6,3629,4514,885,24.39%
Public Service Representative 3,333,7,3790,4714,924,24.38%
Public Service Representative 3,333,8,3964,4930,966,24.37%
Public Service Representative 3,333,9,4155,4936,781,18.80%
Public Service Representative 3,333,10,4356,4943,587,13.48%
Public Service Representative 4,334,1,3629,4514,885,24.39%
Public Service Representative 4,334,2,3790,4714,924,24.38%
Public Service Representative 4,334,3,3964,4930,966,24.37%
Public Service Representative 4,334,4,4155,5168,1013,24.38%
Public Service Representative 4,334,5,4356,5418,1062,24.38%
Public Service Representative 4,334,6,4555,5666,1111,24.39%
Public Service Representative 4,334,7,4776,5941,1165,24.39%
Public Service Representative 4,334,8,5019,6243,1224,24.39%
Public Service Representative 4,334,9,5256,6244,988,18.80%
Public Service Representative 4,334,10,5503,6244,741,13.47%
Radiologic Technologist,6348,1,4555,5666,1111,24.39%
Radiologic Technologist,6348,2,4776,5941,1165,24.39%
Radiologic Technologist,6348,3,5019,6243,1224,24.39%
Radiologic Technologist,6348,4,5256,6538,1282,24.39%
Radiologic Technologist,6348,5,5503,6845,1342,24.39%
Radiologic Technologist,6348,6,5771,7178,1407,24.38%
Radiologic Technologist,6348,7,6051,7527,1476,24.39%
Radiologic Technologist,6348,8,6350,7898,1548,24.38%
Radiologic Technologist,6348,9,6664,7917,1253,18.80%
Radiologic Technologist,6348,10,6982,7922,940,13.46%
Rehabilitation Instructor For The Blind,3333,1,4155,5168,1013,24.38%
Rehabilitation Instructor For The Blind,3333,2,4356,5418,1062,24.38%
Rehabilitation Instructor For The Blind,3333,3,4555,5666,1111,24.39%
Rehabilitation Instructor For The Blind,3333,4,4776,5941,1165,24.39%
Rehabilitation Instructor For The Blind,3333,5,5019,6243,1224,24.39%
Rehabilitation Instructor For The Blind,3333,6,5256,6538,1282,24.39%
Rehabilitation Instructor For The Blind,3333,7,5503,6845,1342,24.39%
Rehabilitation Instructor For The Blind,3333,8,5771,7178,1407,24.38%
Rehabilitation Instructor For The Blind,3333,9,6051,7189,1138,18.81%
Rehabilitation Instructor For The Blind,3333,10,6350,7205,855,13.46%
Rehabilitation Instructor For The Blind (Entry),3333,1,3790,4714,924,24.38%
Rehabilitation Instructor For The Blind (Entry),3333,2,3964,4930,966,24.37%
Rehabilitation Instructor For The Blind (Entry),3333,3,4155,5168,1013,24.38%
Rehabilitation Instructor For The Blind (Entry),3333,4,4356,5418,1062,24.38%
Rehabilitation Instructor For The Blind (Entry),3333,5,4555,5666,1111,24.39%
Rehabilitation Instructor For The Blind (Entry),3333,6,4776,5941,1165,24.39%
Rehabilitation Instructor For The Blind (Entry),3333,7,5019,6243,1224,24.39%
Rehabilitation Instructor For The Blind (Entry),3333,8,5256,6538,1282,24.39%
Rehabilitation Instructor For The Blind (Entry),3333,9,5503,6538,1035,18.81%
Rehabilitation Instructor For The Blind (Entry),3333,10,5771,6548,777,13.46%
Rehabilitation Therapist,6531,1,4356,5418,1062,24.38%
Rehabilitation Therapist,6531,2,4555,5666,1111,24.39%
Rehabilitation Therapist,6531,3,4776,5941,1165,24.39%
Rehabilitation Therapist,6531,4,5019,6243,1224,24.39%
Rehabilitation Therapist,6531,5,5256,6538,1282,24.39%
Rehabilitation Therapist,6531,6,5503,6845,1342,24.39%
Rehabilitation Therapist,6531,7,5771,7178,1407,24.38%
Rehabilitation Therapist,6531,8,6051,7527,1476,24.39%
Rehabilitation Therapist,6531,9,6350,7544,1194,18.80%
Rehabilitation Therapist,6531,10,6664,7562,898,13.48%
Research Analyst 1,1115,1,3483,4332,849,24.38%
Research Analyst 1,1115,2,3629,4514,885,24.39%
Research Analyst 1,1115,3,3790,4714,924,24.38%
Research Analyst 1,1115,4,3964,4930,966,24.37%
Research Analyst 1,1115,5,4155,5168,1013,24.38%
Research Analyst 1,1115,6,4356,5418,1062,24.38%
Research Analyst 1,1115,7,4555,5666,1111,24.39%
Research Analyst 1,1115,8,4776,5941,1165,24.39%
Research Analyst 1,1115,9,5019,5963,944,18.81%
Research Analyst 1,1115,10,5256,5964,708,13.47%
Research Analyst 2,1116,1,4155,5168,1013,24.38%
Research Analyst 2,1116,2,4356,5418,1062,24.38%
Research Analyst 2,1116,3,4555,5666,1111,24.39%
Research Analyst 2,1116,4,4776,5941,1165,24.39%
Research Analyst 2,1116,5,5019,6243,1224,24.39%
Research Analyst 2,1116,6,5256,6538,1282,24.39%
Research Analyst 2,1116,7,5503,6845,1342,24.39%
Research Analyst 2,1116,8,5771,7178,1407,24.38%
Research Analyst 2,1116,9,6051,7189,1138,18.81%
Research Analyst 2,1116,10,6350,7205,855,13.46%
Research Analyst 3,1117,1,4776,5941,1165,24.39%
Research Analyst 3,1117,2,5019,6243,1224,24.39%
Research Analyst 3,1117,3,5256,6538,1282,24.39%
Research Analyst 3,1117,4,5503,6845,1342,24.39%
Research Analyst 3,1117,5,5771,7178,1407,24.38%
Research Analyst 3,1117,6,6051,7527,1476,24.39%
Research Analyst 3,1117,7,6350,7898,1548,24.38%
Research Analyst 3,1117,8,6664,8289,1625,24.38%
Research Analyst 3,1117,9,6982,8295,1313,18.81%
Research Analyst 3,1117,10,7327,8314,987,13.47%
Research Analyst 4,1118,1,5771,7178,1407,24.38%
Research Analyst 4,1118,2,6051,7527,1476,24.39%
Research Analyst 4,1118,3,6350,7898,1548,24.38%
Research Analyst 4,1118,4,6664,8289,1625,24.38%
Research Analyst 4,1118,5,6982,8685,1703,24.39%
Research Analyst 4,1118,6,7327,9114,1787,24.39%
Research Analyst 4,1118,7,7678,9550,1872,24.38%
Research Analyst 4,1118,8,8057,10022,1965,24.39%
Research Analyst 4,1118,9,8450,10039,1589,18.80%
Research Analyst 4,1118,10,8870,10065,1195,13.47%
Retirement Counselor 1,841,1,3629,4514,885,24.39%
Retirement Counselor 1,841,2,3790,4714,924,24.38%
Retirement Counselor 1,841,3,3964,4930,966,24.37%
Retirement Counselor 1,841,4,4155,5168,1013,24.38%
Retirement Counselor 1,841,5,4356,5418,1062,24.38%
Retirement Counselor 1,841,6,4555,5666,1111,24.39%
Retirement Counselor 1,841,7,4776,5941,1165,24.39%
Retirement Counselor 1,841,8,5019,6243,1224,24.39%
Retirement Counselor 1,841,9,5256,6244,988,18.80%
Retirement Counselor 1,841,10,5503,6244,741,13.47%
Retirement Counselor 2,843,1,3964,4930,966,24.37%
Retirement Counselor 2,843,2,4155,5168,1013,24.38%
Retirement Counselor 2,843,3,4356,5418,1062,24.38%
Retirement Counselor 2,843,4,4555,5666,1111,24.39%
Retirement Counselor 2,843,5,4776,5941,1165,24.39%
Retirement Counselor 2,843,6,5019,6243,1224,24.39%
Retirement Counselor 2,843,7,5256,6538,1282,24.39%
Retirement Counselor 2,843,8,5503,6845,1342,24.39%
Retirement Counselor 2,843,9,5771,6856,1085,18.80%
Retirement Counselor 2,843,10,6051,6866,815,13.47%
Revenue Agent 1,5110,1,3218,4002,784,24.36%
Revenue Agent 1,5110,1,3218,4002,784,24.36%
Revenue Agent 1,5110,2,3335,4148,813,24.38%
Revenue Agent 1,5110,2,3335,4148,813,24.38%
Revenue Agent 1,5110,3,3483,4332,849,24.38%
Revenue Agent 1,5110,3,3483,4332,849,24.38%
Revenue Agent 1,5110,4,3629,4514,885,24.39%
Revenue Agent 1,5110,4,3629,4514,885,24.39%
Revenue Agent 1,5110,5,3790,4714,924,24.38%
Revenue Agent 1,5110,5,3790,4714,924,24.38%
Revenue Agent 1,5110,6,3964,4930,966,24.37%
Revenue Agent 1,5110,6,3964,4930,966,24.37%
Revenue Agent 1,5110,7,4155,5168,1013,24.38%
Revenue Agent 1,5110,7,4155,5168,1013,24.38%
Revenue Agent 1,5110,8,4356,5418,1062,24.38%
Revenue Agent 1,5110,8,4356,5418,1062,24.38%
Revenue Agent 1,5110,9,4555,5411,856,18.79%
Revenue Agent 1,5110,9,4555,5411,856,18.79%
Revenue Agent 1,5110,10,4776,5419,643,13.46%
Revenue Agent 1,5110,10,4776,5419,643,13.46%
Revenue Agent 2,5111,1,3483,4332,849,24.38%
Revenue Agent 2,5111,2,3629,4514,885,24.39%
Revenue Agent 2,5111,3,3790,4714,924,24.38%
Revenue Agent 2,5111,4,3964,4930,966,24.37%
Revenue Agent 2,5111,5,4155,5168,1013,24.38%
Revenue Agent 2,5111,6,4356,5418,1062,24.38%
Revenue Agent 2,5111,7,4555,5666,1111,24.39%
Revenue Agent 2,5111,8,4776,5941,1165,24.39%
Revenue Agent 2,5111,9,5019,5963,944,18.81%
Revenue Agent 2,5111,10,5256,5964,708,13.47%
Revenue Agent 3,5113,1,3790,4714,924,24.38%
Revenue Agent 3,5113,2,3964,4930,966,24.37%
Revenue Agent 3,5113,3,4155,5168,1013,24.38%
Revenue Agent 3,5113,4,4356,5418,1062,24.38%
Revenue Agent 3,5113,5,4555,5666,1111,24.39%
Revenue Agent 3,5113,6,4776,5941,1165,24.39%
Revenue Agent 3,5113,7,5019,6243,1224,24.39%
Revenue Agent 3,5113,8,5256,6538,1282,24.39%
Revenue Agent 3,5113,9,5503,6538,1035,18.81%
Revenue Agent 3,5113,10,5771,6548,777,13.46%
Safety Specialist 1,1345,1,4155,5168,1013,24.38%
Safety Specialist 1,1345,2,4356,5418,1062,24.38%
Safety Specialist 1,1345,3,4555,5666,1111,24.39%
Safety Specialist 1,1345,4,4776,5941,1165,24.39%
Safety Specialist 1,1345,5,5019,6243,1224,24.39%
Safety Specialist 1,1345,6,5256,6538,1282,24.39%
Safety Specialist 1,1345,7,5503,6845,1342,24.39%
Safety Specialist 1,1345,8,5771,7178,1407,24.38%
Safety Specialist 1,1345,9,6051,7189,1138,18.81%
Safety Specialist 1,1345,10,6350,7205,855,13.46%
Safety Specialist 2,1346,1,5019,6243,1224,24.39%
Safety Specialist 2,1346,2,5256,6538,1282,24.39%
Safety Specialist 2,1346,3,5503,6845,1342,24.39%
Safety Specialist 2,1346,4,5771,7178,1407,24.38%
Safety Specialist 2,1346,5,6051,7527,1476,24.39%
Safety Specialist 2,1346,6,6350,7898,1548,24.38%
Safety Specialist 2,1346,7,6664,8289,1625,24.38%
Safety Specialist 2,1346,8,6982,8685,1703,24.39%
Safety Specialist 2,1346,9,7327,8705,1378,18.81%
Safety Specialist 2,1346,10,7678,8712,1034,13.47%
Scientific Instrument Technician,4339,1,3790,4714,924,24.38%
Scientific Instrument Technician,4339,2,3964,4930,966,24.37%
Scientific Instrument Technician,4339,3,4155,5168,1013,24.38%
Scientific Instrument Technician,4339,4,4356,5418,1062,24.38%
Scientific Instrument Technician,4339,5,4555,5666,1111,24.39%
Scientific Instrument Technician,4339,6,4776,5941,1165,24.39%
Scientific Instrument Technician,4339,7,5019,6243,1224,24.39%
Scientific Instrument Technician,4339,8,5256,6538,1282,24.39%
Scientific Instrument Technician,4339,9,5503,6538,1035,18.81%
Scientific Instrument Technician,4339,10,5771,6548,777,13.46%
Seamster,9301,1,3005,3913,908,30.22%
Seamster,9301,2,3095,3849,754,24.36%
Seamster,9301,3,3218,4002,784,24.36%
Seamster,9301,4,3335,4148,813,24.38%
Seamster,9301,5,3483,4332,849,24.38%
Seamster,9301,6,3629,4514,885,24.39%
Seamster,9301,7,3790,4714,924,24.38%
Seamster,9301,8,3964,4930,966,24.37%
Seamster,9301,9,4155,4936,781,18.80%
Seamster,9301,10,4356,4943,587,13.48%
Securities Examiner,5671,1,5771,7178,1407,24.38%
Securities Examiner,5671,2,6051,7527,1476,24.39%
Securities Examiner,5671,3,6350,7898,1548,24.38%
Securities Examiner,5671,4,6664,8289,1625,24.38%
Securities Examiner,5671,5,6982,8685,1703,24.39%
Securities Examiner,5671,6,7327,9114,1787,24.39%
Securities Examiner,5671,7,7678,9550,1872,24.38%
Securities Examiner,5671,8,8057,10022,1965,24.39%
Securities Examiner,5671,9,8450,10039,1589,18.80%
Securities Examiner,5671,10,8870,10065,1195,13.47%
Shipping Point Inspector 1,5450,1,3005,3738,733,24.39%
Shipping Point Inspector 1,5450,2,3095,3849,754,24.36%
Shipping Point Inspector 1,5450,3,3218,4002,784,24.36%
Shipping Point Inspector 1,5450,4,3335,4148,813,24.38%
Shipping Point Inspector 1,5450,5,3483,4332,849,24.38%
Shipping Point Inspector 1,5450,6,3629,4514,885,24.39%
Shipping Point Inspector 1,5450,7,3790,4714,924,24.38%
Shipping Point Inspector 1,5450,8,3964,4930,966,24.37%
Shipping Point Inspector 1,5450,9,4155,4936,781,18.80%
Shipping Point Inspector 1,5450,10,4356,4943,587,13.48%
Shipping Point Inspector 2,5451,1,3218,4002,784,24.36%
Shipping Point Inspector 2,5451,2,3335,4148,813,24.38%
Shipping Point Inspector 2,5451,3,3483,4332,849,24.38%
Shipping Point Inspector 2,5451,4,3629,4514,885,24.39%
Shipping Point Inspector 2,5451,5,3790,4714,924,24.38%
Shipping Point Inspector 2,5451,6,3964,4930,966,24.37%
Shipping Point Inspector 2,5451,7,4155,5168,1013,24.38%
Shipping Point Inspector 2,5451,8,4356,5418,1062,24.38%
Shipping Point Inspector 2,5451,9,4555,5411,856,18.79%
Shipping Point Inspector 2,5451,10,4776,5419,643,13.46%
Sign Technician 1,4131,1,3483,4332,849,24.38%
Sign Technician 1,4131,2,3629,4514,885,24.39%
Sign Technician 1,4131,3,3790,4714,924,24.38%
Sign Technician 1,4131,4,3964,4930,966,24.37%
Sign Technician 1,4131,5,4155,5168,1013,24.38%
Sign Technician 1,4131,6,4356,5418,1062,24.38%
Sign Technician 1,4131,7,4555,5666,1111,24.39%
Sign Technician 1,4131,8,4776,5941,1165,24.39%
Sign Technician 1,4131,9,5019,5963,944,18.81%
Sign Technician 1,4131,10,5256,5964,708,13.47%
Social Service Assistant,6609,1,3218,4002,784,24.36%
Social Service Assistant,6609,2,3335,4148,813,24.38%
Social Service Assistant,6609,3,3483,4332,849,24.38%
Social Service Assistant,6609,4,3629,4514,885,24.39%
Social Service Assistant,6609,5,3790,4714,924,24.38%
Social Service Assistant,6609,6,3964,4930,966,24.37%
Social Service Assistant,6609,7,4155,5168,1013,24.38%
Social Service Assistant,6609,8,4356,5418,1062,24.38%
Social Service Assistant,6609,9,4555,5411,856,18.79%
Social Service Assistant,6609,10,4776,5419,643,13.46%
Social Service Specialist 1,6613,1,4555,5666,1111,24.39%
Social Service Specialist 1,6613,2,4776,5941,1165,24.39%
Social Service Specialist 1,6613,3,5019,6243,1224,24.39%
Social Service Specialist 1,6613,4,5256,6538,1282,24.39%
Social Service Specialist 1,6613,5,5503,6845,1342,24.39%
Social Service Specialist 1,6613,6,5771,7178,1407,24.38%
Social Service Specialist 1,6613,7,6051,7527,1476,24.39%
Social Service Specialist 1,6613,8,6350,7898,1548,24.38%
Social Service Specialist 1,6613,9,6664,7917,1253,18.80%
Social Service Specialist 1,6613,10,6982,7922,940,13.46%
Social Services Specialist 2,6613,1,5019,6243,1224,24.39%
Social Services Specialist 2,6613,2,5256,6538,1282,24.39%
Social Services Specialist 2,6613,3,5503,6845,1342,24.39%
Social Services Specialist 2,6613,4,5771,7178,1407,24.38%
Social Services Specialist 2,6613,5,6051,7527,1476,24.39%
Social Services Specialist 2,6613,6,6350,7898,1548,24.38%
Social Services Specialist 2,6613,7,6664,8289,1625,24.38%
Social Services Specialist 2,6613,8,6982,8685,1703,24.39%
Social Services Specialist 2,6613,9,7327,8705,1378,18.81%
Social Services Specialist 2,6613,10,7678,8712,1034,13.47%
State Library Specialist 1,351,1,0,0,0,
State Library Specialist 1,351,2,0,0,0,
State Library Specialist 1,351,3,0,0,0,
State Library Specialist 1,351,4,3005,3738,733,24.39%
State Library Specialist 1,351,5,3095,3849,754,24.36%
State Library Specialist 1,351,6,3218,4002,784,24.36%
State Library Specialist 1,351,7,3335,4148,813,24.38%
State Library Specialist 1,351,8,3483,4332,849,24.38%
State Library Specialist 1,351,9,3629,4311,682,18.79%
State Library Specialist 1,351,10,3790,4300,510,13.46%
State Library Specialist 2,353,1,3335,4148,813,24.38%
State Library Specialist 2,353,2,3483,4332,849,24.38%
State Library Specialist 2,353,3,3629,4514,885,24.39%
State Library Specialist 2,353,4,3790,4714,924,24.38%
State Library Specialist 2,353,5,3964,4930,966,24.37%
State Library Specialist 2,353,6,4155,5168,1013,24.38%
State Library Specialist 2,353,7,4356,5418,1062,24.38%
State Library Specialist 2,353,8,4555,5666,1111,24.39%
State Library Specialist 2,353,9,4776,5674,898,18.80%
State Library Specialist 2,353,10,5019,5695,676,13.47%
State Procurement Analyst,770,1,5771,7178,1407,24.38%
State Procurement Analyst,770,2,6051,7527,1476,24.39%
State Procurement Analyst,770,3,6350,7898,1548,24.38%
State Procurement Analyst,770,4,6664,8289,1625,24.38%
State Procurement Analyst,770,5,6982,8685,1703,24.39%
State Procurement Analyst,770,6,7327,9114,1787,24.39%
State Procurement Analyst,770,7,7678,9550,1872,24.38%
State Procurement Analyst,770,8,8057,10022,1965,24.39%
State Procurement Analyst,770,9,8450,10039,1589,18.80%
State Procurement Analyst,770,10,8870,10065,1195,13.47%
Student Office Worker,100,1,0,4300,4300,
Student Office Worker,100,2,0,4300,4300,
Student Office Worker,100,3,0,4300,4300,
Student Office Worker,100,4,0,4300,4300,
Student Office Worker,100,5,0,4300,4300,
Student Office Worker,100,6,0,4300,4300,
Student Office Worker,100,7,0,4300,4300,
Student Office Worker,100,8,0,4300,4300,
Student Office Worker,100,9,3005,4300,1295,43.09%
Student Office Worker,100,10,3095,4300,1205,38.93%
Supply Specialist 1,758,1,0,0,0,
Supply Specialist 1,758,2,3005,3738,733,24.39%
Supply Specialist 1,758,3,3095,3849,754,24.36%
Supply Specialist 1,758,4,3218,4002,784,24.36%
Supply Specialist 1,758,5,3335,4148,813,24.38%
Supply Specialist 1,758,6,3483,4332,849,24.38%
Supply Specialist 1,758,7,3629,4514,885,24.39%
Supply Specialist 1,758,8,3790,4714,924,24.38%
Supply Specialist 1,758,9,3964,4709,745,18.79%
Supply Specialist 1,758,10,4155,4714,559,13.45%
Supply Specialist 2,759,1,3629,4514,885,24.39%
Supply Specialist 2,759,2,3790,4714,924,24.38%
Supply Specialist 2,759,3,3964,4930,966,24.37%
Supply Specialist 2,759,4,4155,5168,1013,24.38%
Supply Specialist 2,759,5,4356,5418,1062,24.38%
Supply Specialist 2,759,6,4555,5666,1111,24.39%
Supply Specialist 2,759,7,4776,5941,1165,24.39%
Supply Specialist 2,759,8,5019,6243,1224,24.39%
Supply Specialist 2,759,9,5256,6244,988,18.80%
Supply Specialist 2,759,10,5503,6244,741,13.47%
Tax Auditor 1,5631,1,4555,5666,1111,24.39%
Tax Auditor 1,5631,1,4555,5666,1111,24.39%
Tax Auditor 1,5631,2,4776,5941,1165,24.39%
Tax Auditor 1,5631,2,4776,5941,1165,24.39%
Tax Auditor 1,5631,3,5019,6243,1224,24.39%
Tax Auditor 1,5631,3,5019,6243,1224,24.39%
Tax Auditor 1,5631,4,5256,6538,1282,24.39%
Tax Auditor 1,5631,4,5256,6538,1282,24.39%
Tax Auditor 1,5631,5,5503,6845,1342,24.39%
Tax Auditor 1,5631,5,5503,6845,1342,24.39%
Tax Auditor 1,5631,6,5771,7178,1407,24.38%
Tax Auditor 1,5631,6,5771,7178,1407,24.38%
Tax Auditor 1,5631,7,6051,7527,1476,24.39%
Tax Auditor 1,5631,7,6051,7527,1476,24.39%
Tax Auditor 1,5631,8,6350,7898,1548,24.38%
Tax Auditor 1,5631,8,6350,7898,1548,24.38%
Tax Auditor 1,5631,9,6664,7917,1253,18.80%
Tax Auditor 1,5631,9,6664,7917,1253,18.80%
Tax Auditor 1,5631,10,6982,7922,940,13.46%
Tax Auditor 1,5631,10,6982,7922,940,13.46%
Tax Auditor 2,5633,1,5256,6538,1282,24.39%
Tax Auditor 2,5633,1,5256,6538,1282,24.39%
Tax Auditor 2,5633,2,5503,6845,1342,24.39%
Tax Auditor 2,5633,2,5503,6845,1342,24.39%
Tax Auditor 2,5633,3,5771,7178,1407,24.38%
Tax Auditor 2,5633,3,5771,7178,1407,24.38%
Tax Auditor 2,5633,4,6051,7527,1476,24.39%
Tax Auditor 2,5633,4,6051,7527,1476,24.39%
Tax Auditor 2,5633,5,6350,7898,1548,24.38%
Tax Auditor 2,5633,5,6350,7898,1548,24.38%
Tax Auditor 2,5633,6,6664,8289,1625,24.38%
Tax Auditor 2,5633,6,6664,8289,1625,24.38%
Tax Auditor 2,5633,7,6982,8685,1703,24.39%
Tax Auditor 2,5633,7,6982,8685,1703,24.39%
Tax Auditor 2,5633,8,7327,9114,1787,24.39%
Tax Auditor 2,5633,8,7327,9114,1787,24.39%
Tax Auditor 2,5633,9,7678,9122,1444,18.81%
Tax Auditor 2,5633,9,7678,9122,1444,18.81%
Tax Auditor 2,5633,10,8057,9142,1085,13.47%
Tax Auditor 2,5633,10,8057,9142,1085,13.47%
Tax Auditor/Entry,5630,1,3629,4514,885,24.39%
Tax Auditor/Entry,5630,2,3790,4714,924,24.38%
Tax Auditor/Entry,5630,3,3964,4930,966,24.37%
Tax Auditor/Entry,5630,4,4155,5168,1013,24.38%
Tax Auditor/Entry,5630,5,4356,5418,1062,24.38%
Tax Auditor/Entry,5630,6,4555,5666,1111,24.39%
Tax Auditor/Entry,5630,7,4776,5941,1165,24.39%
Tax Auditor/Entry,5630,8,5019,6243,1224,24.39%
Tax Auditor/Entry,5630,9,5256,6244,988,18.80%
Tax Auditor/Entry,5630,10,5503,6244,741,13.47%
Teaching Assistant,3303,1,3005,3738,733,24.39%
Teaching Assistant,3303,2,3095,3849,754,24.36%
Teaching Assistant,3303,3,3218,4002,784,24.36%
Teaching Assistant,3303,4,3335,4148,813,24.38%
Teaching Assistant,3303,5,3483,4332,849,24.38%
Teaching Assistant,3303,6,3629,4514,885,24.39%
Teaching Assistant,3303,7,3790,4714,924,24.38%
Teaching Assistant,3303,8,3964,4930,966,24.37%
Teaching Assistant,3303,9,4155,4936,781,18.80%
Teaching Assistant,3303,10,4356,4943,587,13.48%
Traffic Survey Interviewer,1105,1,0,0,0,
Traffic Survey Interviewer,1105,2,0,0,0,
Traffic Survey Interviewer,1105,3,0,0,0,
Traffic Survey Interviewer,1105,4,0,0,0,
Traffic Survey Interviewer,1105,5,0,0,0,
Traffic Survey Interviewer,1105,6,0,0,0,
Traffic Survey Interviewer,1105,7,0,0,0,
Traffic Survey Interviewer,1105,8,3005,3738,733,24.39%
Traffic Survey Interviewer,1105,9,3095,3677,582,18.80%
Traffic Survey Interviewer,1105,10,3218,3651,433,13.46%
Training & Development Specialist 1,1338,1,4155,5168,1013,24.38%
Training & Development Specialist 1,1338,2,4356,5418,1062,24.38%
Training & Development Specialist 1,1338,3,4555,5666,1111,24.39%
Training & Development Specialist 1,1338,4,4776,5941,1165,24.39%
Training & Development Specialist 1,1338,5,5019,6243,1224,24.39%
Training & Development Specialist 1,1338,6,5256,6538,1282,24.39%
Training & Development Specialist 1,1338,7,5503,6845,1342,24.39%
Training & Development Specialist 1,1338,8,5771,7178,1407,24.38%
Training & Development Specialist 1,1338,9,6051,7189,1138,18.81%
Training & Development Specialist 1,1338,10,6350,7205,855,13.46%
Training & Development Specialist 2,1339,1,5019,6243,1224,24.39%
Training & Development Specialist 2,1339,2,5256,6538,1282,24.39%
Training & Development Specialist 2,1339,3,5503,6845,1342,24.39%
Training & Development Specialist 2,1339,4,5771,7178,1407,24.38%
Training & Development Specialist 2,1339,5,6051,7527,1476,24.39%
Training & Development Specialist 2,1339,6,6350,7898,1548,24.38%
Training & Development Specialist 2,1339,7,6664,8289,1625,24.38%
Training & Development Specialist 2,1339,8,6982,8685,1703,24.39%
Training & Development Specialist 2,1339,9,7327,8705,1378,18.81%
Training & Development Specialist 2,1339,10,7678,8712,1034,13.47%
Transportation Maintenance Coordinator 1,4161,1,3790,4714,924,24.38%
Transportation Maintenance Coordinator 1,4161,2,3964,4930,966,24.37%
Transportation Maintenance Coordinator 1,4161,3,4155,5168,1013,24.38%
Transportation Maintenance Coordinator 1,4161,4,4356,5418,1062,24.38%
Transportation Maintenance Coordinator 1,4161,5,4555,5666,1111,24.39%
Transportation Maintenance Coordinator 1,4161,6,4776,5941,1165,24.39%
Transportation Maintenance Coordinator 1,4161,7,5019,6243,1224,24.39%
Transportation Maintenance Coordinator 1,4161,8,5256,6538,1282,24.39%
Transportation Maintenance Coordinator 1,4161,9,5503,6538,1035,18.81%
Transportation Maintenance Coordinator 1,4161,10,5771,6548,777,13.46%
Transportation Maintenance Coordinator 2,4163,1,3964,4930,966,24.37%
Transportation Maintenance Coordinator 2,4163,2,4155,5168,1013,24.38%
Transportation Maintenance Coordinator 2,4163,3,4356,5418,1062,24.38%
Transportation Maintenance Coordinator 2,4163,4,4555,5666,1111,24.39%
Transportation Maintenance Coordinator 2,4163,5,4776,5941,1165,24.39%
Transportation Maintenance Coordinator 2,4163,6,5019,6243,1224,24.39%
Transportation Maintenance Coordinator 2,4163,7,5256,6538,1282,24.39%
Transportation Maintenance Coordinator 2,4163,8,5503,6845,1342,24.39%
Transportation Maintenance Coordinator 2,4163,9,5771,6856,1085,18.80%
Transportation Maintenance Coordinator 2,4163,10,6051,6866,815,13.47%
Transportation Maintenance Specialist 1,4151,1,3218,4002,784,24.36%
Transportation Maintenance Specialist 1,4151,2,3335,4148,813,24.38%
Transportation Maintenance Specialist 1,4151,3,3483,4332,849,24.38%
Transportation Maintenance Specialist 1,4151,4,3629,4514,885,24.39%
Transportation Maintenance Specialist 1,4151,5,3790,4714,924,24.38%
Transportation Maintenance Specialist 1,4151,6,3964,4930,966,24.37%
Transportation Maintenance Specialist 1,4151,7,4155,5168,1013,24.38%
Transportation Maintenance Specialist 1,4151,8,4356,5418,1062,24.38%
Transportation Maintenance Specialist 1,4151,9,4555,5411,856,18.79%
Transportation Maintenance Specialist 1,4151,10,4776,5419,643,13.46%
Transportation Maintenance Specialist 2,4153,1,3483,4332,849,24.38%
Transportation Maintenance Specialist 2,4153,1,3483,4332,849,24.38%
Transportation Maintenance Specialist 2,4153,2,3629,4514,885,24.39%
Transportation Maintenance Specialist 2,4153,2,3629,4514,885,24.39%
Transportation Maintenance Specialist 2,4153,3,3790,4714,924,24.38%
Transportation Maintenance Specialist 2,4153,3,3790,4714,924,24.38%
Transportation Maintenance Specialist 2,4153,4,3964,4930,966,24.37%
Transportation Maintenance Specialist 2,4153,4,3964,4930,966,24.37%
Transportation Maintenance Specialist 2,4153,5,4155,5168,1013,24.38%
Transportation Maintenance Specialist 2,4153,5,4155,5168,1013,24.38%
Transportation Maintenance Specialist 2,4153,6,4356,5418,1062,24.38%
Transportation Maintenance Specialist 2,4153,6,4356,5418,1062,24.38%
Transportation Maintenance Specialist 2,4153,7,4555,5666,1111,24.39%
Transportation Maintenance Specialist 2,4153,7,4555,5666,1111,24.39%
Transportation Maintenance Specialist 2,4153,8,4776,5941,1165,24.39%
Transportation Maintenance Specialist 2,4153,8,4776,5941,1165,24.39%
Transportation Maintenance Specialist 2,4153,9,5019,5963,944,18.81%
Transportation Maintenance Specialist 2,4153,9,5019,5963,944,18.81%
Transportation Maintenance Specialist 2,4153,10,5256,5964,708,13.47%
Transportation Maintenance Specialist 2,4153,10,5256,5964,708,13.47%
Transportation Maintenance Specialist Entry,4150,1,0,0,0,
Transportation Maintenance Specialist Entry,4150,2,0,0,0,
Transportation Maintenance Specialist Entry,4150,3,0,0,0,
Transportation Maintenance Specialist Entry,4150,4,0,0,0,
Transportation Maintenance Specialist Entry,4150,5,3335,4148,813,24.38%
Transportation Maintenance Specialist Entry,4150,6,3483,4332,849,24.38%
Transportation Maintenance Specialist Entry,4150,7,3629,4514,885,24.39%
Transportation Maintenance Specialist Entry,4150,8,3790,4714,924,24.38%
Transportation Maintenance Specialist Entry,4150,9,3964,4709,745,18.79%
Transportation Maintenance Specialist Entry,4150,10,4155,4714,559,13.45%
Transportation Services Office Leader,333,1,3790,4714,924,24.38%
Transportation Services Office Leader,333,2,3964,4930,966,24.37%
Transportation Services Office Leader,333,3,4155,5168,1013,24.38%
Transportation Services Office Leader,333,4,4356,5418,1062,24.38%
Transportation Services Office Leader,333,5,4555,5666,1111,24.39%
Transportation Services Office Leader,333,6,4776,5941,1165,24.39%
Transportation Services Office Leader,333,7,5019,6243,1224,24.39%
Transportation Services Office Leader,333,8,5256,6538,1282,24.39%
Transportation Services Office Leader,333,9,5503,6538,1035,18.81%
Transportation Services Office Leader,333,10,5771,6548,777,13.46%
Transportation Services Representative 1,331,1,3218,4002,784,24.36%
Transportation Services Representative 1,331,2,3335,4148,813,24.38%
Transportation Services Representative 1,331,3,3483,4332,849,24.38%
Transportation Services Representative 1,331,4,3629,4514,885,24.39%
Transportation Services Representative 1,331,5,3790,4714,924,24.38%
Transportation Services Representative 1,331,6,3964,4930,966,24.37%
Transportation Services Representative 1,331,7,4155,5168,1013,24.38%
Transportation Services Representative 1,331,8,4356,5418,1062,24.38%
Transportation Services Representative 1,331,9,4555,5411,856,18.79%
Transportation Services Representative 1,331,10,4776,5419,643,13.46%
Transportation Services Representative 2,333,1,3483,4332,849,24.38%
Transportation Services Representative 2,333,2,3629,4514,885,24.39%
Transportation Services Representative 2,333,3,3790,4714,924,24.38%
Transportation Services Representative 2,333,4,3964,4930,966,24.37%
Transportation Services Representative 2,333,5,4155,5168,1013,24.38%
Transportation Services Representative 2,333,6,4356,5418,1062,24.38%
Transportation Services Representative 2,333,7,4555,5666,1111,24.39%
Transportation Services Representative 2,333,8,4776,5941,1165,24.39%
Transportation Services Representative 2,333,9,5019,5963,944,18.81%
Transportation Services Representative 2,333,10,5256,5964,708,13.47%
Transportation Telecommunications Specialist 1,4166,1,3629,4514,885,24.39%
Transportation Telecommunications Specialist 1,4166,2,3790,4714,924,24.38%
Transportation Telecommunications Specialist 1,4166,3,3964,4930,966,24.37%
Transportation Telecommunications Specialist 1,4166,4,4155,5168,1013,24.38%
Transportation Telecommunications Specialist 1,4166,5,4356,5418,1062,24.38%
Transportation Telecommunications Specialist 1,4166,6,4555,5666,1111,24.39%
Transportation Telecommunications Specialist 1,4166,7,4776,5941,1165,24.39%
Transportation Telecommunications Specialist 1,4166,8,5019,6243,1224,24.39%
Transportation Telecommunications Specialist 1,4166,9,5256,6244,988,18.80%
Transportation Telecommunications Specialist 1,4166,10,5503,6244,741,13.47%
Transportation Telecommunications Specialist 2,4167,1,3964,4930,966,24.37%
Transportation Telecommunications Specialist 2,4167,2,4155,5168,1013,24.38%
Transportation Telecommunications Specialist 2,4167,3,4356,5418,1062,24.38%
Transportation Telecommunications Specialist 2,4167,4,4555,5666,1111,24.39%
Transportation Telecommunications Specialist 2,4167,5,4776,5941,1165,24.39%
Transportation Telecommunications Specialist 2,4167,6,5019,6243,1224,24.39%
Transportation Telecommunications Specialist 2,4167,7,5256,6538,1282,24.39%
Transportation Telecommunications Specialist 2,4167,8,5503,6845,1342,24.39%
Transportation Telecommunications Specialist 2,4167,9,5771,6856,1085,18.80%
Transportation Telecommunications Specialist 2,4167,10,6051,6866,815,13.47%
Transporter,4403,1,0,0,0,
Transporter,4403,2,0,0,0,
Transporter,4403,3,0,0,0,
Transporter,4403,4,0,0,0,
Transporter,4403,5,3005,3738,733,24.39%
Transporter,4403,6,3095,3849,754,24.36%
Transporter,4403,7,3218,4002,784,24.36%
Transporter,4403,8,3335,4148,813,24.38%
Transporter,4403,9,3483,4138,655,18.81%
Transporter,4403,10,3629,4118,489,13.47%
Transporting Mental Health Aide,6101,1,3218,4191,973,30.24%
Transporting Mental Health Aide,6101,2,3335,4148,813,24.38%
Transporting Mental Health Aide,6101,3,3483,4332,849,24.38%
Transporting Mental Health Aide,6101,4,3629,4514,885,24.39%
Transporting Mental Health Aide,6101,5,3790,4714,924,24.38%
Transporting Mental Health Aide,6101,6,3964,4930,966,24.37%
Transporting Mental Health Aide,6101,7,4155,5168,1013,24.38%
Transporting Mental Health Aide,6101,8,4356,5418,1062,24.38%
Transporting Mental Health Aide,6101,9,4555,5411,856,18.79%
Transporting Mental Health Aide,6101,10,4776,5419,643,13.46%
Truck Driver 1,4401,1,3218,4002,784,24.36%
Truck Driver 1,4401,2,3335,4148,813,24.38%
Truck Driver 1,4401,3,3483,4332,849,24.38%
Truck Driver 1,4401,4,3629,4514,885,24.39%
Truck Driver 1,4401,5,3790,4714,924,24.38%
Truck Driver 1,4401,6,3964,4930,966,24.37%
Truck Driver 1,4401,7,4155,5168,1013,24.38%
Truck Driver 1,4401,8,4356,5418,1062,24.38%
Truck Driver 1,4401,9,4555,5411,856,18.79%
Truck Driver 1,4401,10,4776,5419,643,13.46%
Truck Driver 2,4403,1,3629,4514,885,24.39%
Truck Driver 2,4403,2,3790,4714,924,24.38%
Truck Driver 2,4403,3,3964,4930,966,24.37%
Truck Driver 2,4403,4,4155,5168,1013,24.38%
Truck Driver 2,4403,5,4356,5418,1062,24.38%
Truck Driver 2,4403,6,4555,5666,1111,24.39%
Truck Driver 2,4403,7,4776,5941,1165,24.39%
Truck Driver 2,4403,8,5019,6243,1224,24.39%
Truck Driver 2,4403,9,5256,6244,988,18.80%
Truck Driver 2,4403,10,5503,6244,741,13.47%
Veterans Service Officer,799,1,4155,5168,1013,24.38%
Veterans Service Officer,799,2,4356,5418,1062,24.38%
Veterans Service Officer,799,3,4555,5666,1111,24.39%
Veterans Service Officer,799,4,4776,5941,1165,24.39%
Veterans Service Officer,799,5,5019,6243,1224,24.39%
Veterans Service Officer,799,6,5256,6538,1282,24.39%
Veterans Service Officer,799,7,5503,6845,1342,24.39%
Veterans Service Officer,799,8,5771,7178,1407,24.38%
Veterans Service Officer,799,9,6051,7189,1138,18.81%
Veterans Service Officer,799,10,6350,7205,855,13.46%
Veterans Trust Officer,784,1,4155,5168,1013,24.38%
Veterans Trust Officer,784,2,4356,5418,1062,24.38%
Veterans Trust Officer,784,3,4555,5666,1111,24.39%
Veterans Trust Officer,784,4,4776,5941,1165,24.39%
Veterans Trust Officer,784,5,5019,6243,1224,24.39%
Veterans Trust Officer,784,6,5256,6538,1282,24.39%
Veterans Trust Officer,784,7,5503,6845,1342,24.39%
Veterans Trust Officer,784,8,5771,7178,1407,24.38%
Veterans Trust Officer,784,9,6051,7189,1138,18.81%
Veterans Trust Officer,784,10,6350,7205,855,13.46%
Video Producer,3176,1,5256,6538,1282,24.39%
Video Producer,3176,2,5503,6845,1342,24.39%
Video Producer,3176,3,5771,7178,1407,24.38%
Video Producer,3176,4,6051,7527,1476,24.39%
Video Producer,3176,5,6350,7898,1548,24.38%
Video Producer,3176,6,6664,8289,1625,24.38%
Video Producer,3176,7,6982,8685,1703,24.39%
Video Producer,3176,8,7327,9114,1787,24.39%
Video Producer,3176,9,7678,9122,1444,18.81%
Video Producer,3176,10,8057,9142,1085,13.47%
Vocational Rehabilitation Counselor,6647,1,4555,5666,1111,24.39%
Vocational Rehabilitation Counselor,6647,2,4776,5941,1165,24.39%
Vocational Rehabilitation Counselor,6647,3,5019,6243,1224,24.39%
Vocational Rehabilitation Counselor,6647,4,5256,6538,1282,24.39%
Vocational Rehabilitation Counselor,6647,5,5503,6845,1342,24.39%
Vocational Rehabilitation Counselor,6647,6,5771,7178,1407,24.38%
Vocational Rehabilitation Counselor,6647,7,6051,7527,1476,24.39%
Vocational Rehabilitation Counselor,6647,8,6350,7898,1548,24.38%
Vocational Rehabilitation Counselor,6647,9,6664,7917,1253,18.80%
Vocational Rehabilitation Counselor,6647,10,6982,7922,940,13.46%
Vocational Rehabilitation Counselor Entry,6646,1,3629,4514,885,24.39%
Vocational Rehabilitation Counselor Entry,6646,2,3790,4714,924,24.38%
Vocational Rehabilitation Counselor Entry,6646,3,3964,4930,966,24.37%
Vocational Rehabilitation Counselor Entry,6646,4,4155,5168,1013,24.38%
Vocational Rehabilitation Counselor Entry,6646,5,4356,5418,1062,24.38%
Vocational Rehabilitation Counselor Entry,6646,6,4555,5666,1111,24.39%
Vocational Rehabilitation Counselor Entry,6646,7,4776,5941,1165,24.39%
Vocational Rehabilitation Counselor Entry,6646,8,5019,6243,1224,24.39%
Vocational Rehabilitation Counselor Entry,6646,9,5256,6244,988,18.80%
Vocational Rehabilitation Counselor Entry,6646,10,5503,6244,741,13.47%
Vocational Rehabilitation Specialist,6648,1,4776,5941,1165,24.39%
Vocational Rehabilitation Specialist,6648,2,5019,6243,1224,24.39%
Vocational Rehabilitation Specialist,6648,3,5256,6538,1282,24.39%
Vocational Rehabilitation Specialist,6648,4,5503,6845,1342,24.39%
Vocational Rehabilitation Specialist,6648,5,5771,7178,1407,24.38%
Vocational Rehabilitation Specialist,6648,6,6051,7527,1476,24.39%
Vocational Rehabilitation Specialist,6648,7,6350,7898,1548,24.38%
Vocational Rehabilitation Specialist,6648,8,6664,8289,1625,24.38%
Vocational Rehabilitation Specialist,6648,9,6982,8295,1313,18.81%
Vocational Rehabilitation Specialist,6648,10,7327,8314,987,13.47%
Water Resource Data Technician 1,8510,1,3483,4332,849,24.38%
Water Resource Data Technician 1,8510,2,3629,4514,885,24.39%
Water Resource Data Technician 1,8510,3,3790,4714,924,24.38%
Water Resource Data Technician 1,8510,4,3964,4930,966,24.37%
Water Resource Data Technician 1,8510,5,4155,5168,1013,24.38%
Water Resource Data Technician 1,8510,6,4356,5418,1062,24.38%
Water Resource Data Technician 1,8510,7,4555,5666,1111,24.39%
Water Resource Data Technician 1,8510,8,4776,5941,1165,24.39%
Water Resource Data Technician 1,8510,9,5019,5963,944,18.81%
Water Resource Data Technician 1,8510,10,5256,5964,708,13.47%
Water Resource Data Technician 2,8511,1,3790,4714,924,24.38%
Water Resource Data Technician 2,8511,2,3964,4930,966,24.37%
Water Resource Data Technician 2,8511,3,4155,5168,1013,24.38%
Water Resource Data Technician 2,8511,4,4356,5418,1062,24.38%
Water Resource Data Technician 2,8511,5,4555,5666,1111,24.39%
Water Resource Data Technician 2,8511,6,4776,5941,1165,24.39%
Water Resource Data Technician 2,8511,7,5019,6243,1224,24.39%
Water Resource Data Technician 2,8511,8,5256,6538,1282,24.39%
Water Resource Data Technician 2,8511,9,5503,6538,1035,18.81%
Water Resource Data Technician 2,8511,10,5771,6548,777,13.46%
Wildland Fire Dispatcher,8364,1,3005,3738,733,24.39%
Wildland Fire Dispatcher,8364,2,3095,3849,754,24.36%
Wildland Fire Dispatcher,8364,3,3218,4002,784,24.36%
Wildland Fire Dispatcher,8364,4,3335,4148,813,24.38%
Wildland Fire Dispatcher,8364,5,3483,4332,849,24.38%
Wildland Fire Dispatcher,8364,6,3629,4514,885,24.39%
Wildland Fire Dispatcher,8364,7,3790,4714,924,24.38%
Wildland Fire Dispatcher,8364,8,3964,4930,966,24.37%
Wildland Fire Dispatcher,8364,9,4155,4936,781,18.80%
Wildland Fire Dispatcher,8364,10,4356,4943,587,13.48%
Wildland Fire Dispatcher Entry,8363,1,0,0,0,
Wildland Fire Dispatcher Entry,8363,2,0,0,0,
Wildland Fire Dispatcher Entry,8363,3,0,0,0,
Wildland Fire Dispatcher Entry,8363,4,0,0,0,
Wildland Fire Dispatcher Entry,8363,5,3005,3738,733,24.39%
Wildland Fire Dispatcher Entry,8363,6,3095,3849,754,24.36%
Wildland Fire Dispatcher Entry,8363,7,3218,4002,784,24.36%
Wildland Fire Dispatcher Entry,8363,8,3335,4148,813,24.38%
Wildland Fire Dispatcher Entry,8363,9,3483,4138,655,18.81%
Wildland Fire Dispatcher Entry,8363,10,3629,4118,489,13.47%
Wildland Fire Suppression Specialist,8355,1,3218,4002,784,24.36%
Wildland Fire Suppression Specialist,8355,2,3335,4148,813,24.38%
Wildland Fire Suppression Specialist,8355,3,3483,4332,849,24.38%
Wildland Fire Suppression Specialist,8355,4,3629,4514,885,24.39%
Wildland Fire Suppression Specialist,8355,5,3790,4714,924,24.38%
Wildland Fire Suppression Specialist,8355,6,3964,4930,966,24.37%
Wildland Fire Suppression Specialist,8355,7,4155,5168,1013,24.38%
Wildland Fire Suppression Specialist,8355,8,4356,5418,1062,24.38%
Wildland Fire Suppression Specialist,8355,9,4555,5411,856,18.79%
Wildland Fire Suppression Specialist,8355,10,4776,5419,643,13.46%
Wildland Fire Suppression Specialist Entry,8354,1,0,0,0,
Wildland Fire Suppression Specialist Entry,8354,2,0,0,0,
Wildland Fire Suppression Specialist Entry,8354,3,3005,3738,733,24.39%
Wildland Fire Suppression Specialist Entry,8354,4,3095,3849,754,24.36%
Wildland Fire Suppression Specialist Entry,8354,5,3218,4002,784,24.36%
Wildland Fire Suppression Specialist Entry,8354,6,3335,4148,813,24.38%
Wildland Fire Suppression Specialist Entry,8354,7,3483,4332,849,24.38%
Wildland Fire Suppression Specialist Entry,8354,8,3629,4514,885,24.39%
Wildland Fire Suppression Specialist Entry,8354,9,3790,4502,712,18.79%
Wildland Fire Suppression Specialist Entry,8354,10,3964,4498,534,13.47%
Word Processing Technician 2,531,1,0,0,0,
Word Processing Technician 2,531,2,3005,3738,733,24.39%
Word Processing Technician 2,531,3,3095,3849,754,24.36%
Word Processing Technician 2,531,4,3218,4002,784,24.36%
Word Processing Technician 2,531,5,3335,4148,813,24.38%
Word Processing Technician 2,531,6,3483,4332,849,24.38%
Word Processing Technician 2,531,7,3629,4514,885,24.39%
Word Processing Technician 2,531,8,3790,4714,924,24.38%
Word Processing Technician 2,531,9,3964,4709,745,18.79%
Word Processing Technician 2,531,10,4155,4714,559,13.45%
Word Processing Technician 3,533,1,3095,3849,754,24.36%
Word Processing Technician 3,533,2,3218,4002,784,24.36%
Word Processing Technician 3,533,3,3335,4148,813,24.38%
Word Processing Technician 3,533,4,3483,4332,849,24.38%
Word Processing Technician 3,533,5,3629,4514,885,24.39%
Word Processing Technician 3,533,6,3790,4714,924,24.38%
Word Processing Technician 3,533,7,3964,4930,966,24.37%
Word Processing Technician 3,533,8,4155,5168,1013,24.38%
Word Processing Technician 3,533,9,4356,5175,819,18.80%
Word Processing Technician 3,533,10,4555,5168,613,13.46%
Youth Corrections Unit Coordinator,6755,1,4155,5168,1013,24.38%
Youth Corrections Unit Coordinator,6755,2,4356,5418,1062,24.38%
Youth Corrections Unit Coordinator,6755,3,4555,5666,1111,24.39%
Youth Corrections Unit Coordinator,6755,4,4776,5941,1165,24.39%
Youth Corrections Unit Coordinator,6755,5,5019,6243,1224,24.39%
Youth Corrections Unit Coordinator,6755,6,5256,6538,1282,24.39%
Youth Corrections Unit Coordinator,6755,7,5503,6845,1342,24.39%
Youth Corrections Unit Coordinator,6755,8,5771,7178,1407,24.38%
Youth Corrections Unit Coordinator,6755,9,6051,7189,1138,18.81%
Youth Corrections Unit Coordinator,6755,10,6350,7205,855,13.46%
,,,,,,