Position,Classification_Code,Starting step,Coalition,Current monthly pay,2024 monthly pay,2025 monthly pay,2024 monthly difference (2024-current),2025 monthly difference (2025 - current),Total increase over the contract,Annual pay at current monthly pay,Annual pay at monthly pay at end of contract
Accountant 1,1316,1,Strikeable,4155,4639,5169,484,1014,11748,49860,62028
Accountant 1,1316,2,Strikeable,4356,4851,5420,495,1064,12244,52272,65040
Accountant 1,1316,3,Strikeable,4555,5086,5695,531,1140,12735,54660,68340
Accountant 1,1316,4,Strikeable,4776,5345,5964,569,1188,13280,57312,71568
Accountant 1,1316,5,Strikeable,5019,5598,6245,579,1226,13879,60228,74940
Accountant 1,1316,6,Strikeable,5256,5861,6549,605,1293,14464,63072,78588
Accountant 1,1316,7,Strikeable,5503,6146,6866,643,1363,15073,66036,82392
Accountant 1,1316,8,Strikeable,5771,6444,7206,673,1435,15734,69252,86472
Accountant 1,1316,9,Strikeable,6051,6763,7206,712,1155,16424,72612,86472
Accountant 1,1316,10,Strikeable,6350,6763,7206,413,856,17162,76200,86472
Accountant 2,1317,1,Strikeable,5019,5598,6245,579,1226,13879,60228,74940
Accountant 2,1317,2,Strikeable,5256,5861,6549,605,1293,14464,63072,78588
Accountant 2,1317,3,Strikeable,5503,6146,6866,643,1363,15073,66036,82392
Accountant 2,1317,4,Strikeable,5771,6444,7206,673,1435,15734,69252,86472
Accountant 2,1317,5,Strikeable,6051,6763,7562,712,1511,16424,72612,90744
Accountant 2,1317,6,Strikeable,6350,7097,7923,747,1573,17162,76200,95076
Accountant 2,1317,7,Strikeable,6664,7436,8314,772,1650,17936,79968,99768
Accountant 2,1317,8,Strikeable,6982,7803,8713,821,1731,18721,83784,104556
Accountant 2,1317,9,Strikeable,7327,8177,8713,850,1386,19571,87924,104556
Accountant 2,1317,10,Strikeable,7678,8177,8713,499,1035,20437,92136,104556
Accountant 3,1318,1,Strikeable,5771,6444,7206,673,1435,15734,69252,86472
Accountant 3,1318,2,Strikeable,6051,6763,7562,712,1511,16424,72612,90744
Accountant 3,1318,3,Strikeable,6350,7097,7923,747,1573,17162,76200,95076
Accountant 3,1318,4,Strikeable,6664,7436,8314,772,1650,17936,79968,99768
Accountant 3,1318,5,Strikeable,6982,7803,8713,821,1731,18721,83784,104556
Accountant 3,1318,6,Strikeable,7327,8177,9143,850,1816,19571,87924,109716
Accountant 3,1318,7,Strikeable,7678,8581,9589,903,1911,20437,92136,115068
Accountant 3,1318,8,Strikeable,8057,8999,10065,942,2008,21372,96684,120780
Accountant 3,1318,9,Strikeable,8450,9447,10065,997,1615,22341,101400,120780
Accountant 3,1318,10,Strikeable,8870,9447,10065,577,1195,23377,106440,120780
Accounting Technician,313,1,Strikeable,3483,4036,4498,553,1015,10091,41796,53976
Accounting Technician,313,2,Strikeable,3629,4036,4498,407,869,10451,43548,53976
Accounting Technician,313,3,Strikeable,3790,4222,4715,432,925,10848,45480,56580
Accounting Technician,313,4,Strikeable,3964,4425,4943,461,979,11277,47568,59316
Accounting Technician,313,5,Strikeable,4155,4639,5169,484,1014,11748,49860,62028
Accounting Technician,313,6,Strikeable,4356,4851,5420,495,1064,12244,52272,65040
Accounting Technician,313,7,Strikeable,4555,5086,5695,531,1140,12735,54660,68340
Accounting Technician,313,8,Strikeable,4776,5345,5964,569,1188,13280,57312,71568
Accounting Technician,313,9,Strikeable,5019,5598,5964,579,945,13879,60228,71568
Accounting Technician,313,10,Strikeable,5256,5598,5964,342,708,14464,63072,71568
Activities Coordinator,6530,1,Strikeable,3483,4222,4715,739,1232,10091,41796,56580
Activities Coordinator,6530,2,Strikeable,3629,4222,4715,593,1086,10451,43548,56580
Activities Coordinator,6530,3,Strikeable,3790,4222,4715,432,925,10848,45480,56580
Activities Coordinator,6530,4,Strikeable,3964,4425,4943,461,979,11277,47568,59316
Activities Coordinator,6530,5,Strikeable,4155,4639,5169,484,1014,11748,49860,62028
Activities Coordinator,6530,6,Strikeable,4356,4851,5420,495,1064,12244,52272,65040
Activities Coordinator,6530,7,Strikeable,4555,5086,5695,531,1140,12735,54660,68340
Activities Coordinator,6530,8,Strikeable,4776,5345,5964,569,1188,13280,57312,71568
Activities Coordinator,6530,9,Strikeable,5019,5598,5964,579,945,13879,60228,71568
Activities Coordinator,6530,10,Strikeable,5256,5598,5964,342,708,14464,63072,71568
Administrative Law Judge 1,1510,1,Strikeable,5771,6444,7206,673,1435,15734,69252,86472
Administrative Law Judge 1,1510,2,Strikeable,6051,6763,7562,712,1511,16424,72612,90744
Administrative Law Judge 1,1510,3,Strikeable,6350,7097,7923,747,1573,17162,76200,95076
Administrative Law Judge 1,1510,4,Strikeable,6664,7436,8314,772,1650,17936,79968,99768
Administrative Law Judge 1,1510,5,Strikeable,6982,7803,8713,821,1731,18721,83784,104556
Administrative Law Judge 1,1510,6,Strikeable,7327,8177,9143,850,1816,19571,87924,109716
Administrative Law Judge 1,1510,7,Strikeable,7678,8581,9589,903,1911,20437,92136,115068
Administrative Law Judge 1,1510,8,Strikeable,8057,8999,10065,942,2008,21372,96684,120780
Administrative Law Judge 1,1510,9,Strikeable,8450,9447,10065,997,1615,22341,101400,120780
Administrative Law Judge 1,1510,10,Strikeable,8870,9447,10065,577,1195,23377,106440,120780
Administrative Law Judge 2,1511,1,Strikeable,6664,7436,8314,772,1650,17936,79968,99768
Administrative Law Judge 2,1511,2,Strikeable,6982,7803,8713,821,1731,18721,83784,104556
Administrative Law Judge 2,1511,3,Strikeable,7327,8177,9143,850,1816,19571,87924,109716
Administrative Law Judge 2,1511,4,Strikeable,7678,8581,9589,903,1911,20437,92136,115068
Administrative Law Judge 2,1511,5,Strikeable,8057,8999,10065,942,2008,21372,96684,120780
Administrative Law Judge 2,1511,6,Strikeable,8450,9447,10545,997,2095,22341,101400,126540
Administrative Law Judge 2,1511,7,Strikeable,8870,9897,11065,1027,2195,23377,106440,132780
Administrative Law Judge 2,1511,8,Strikeable,9293,10385,11622,1092,2329,24420,111516,139464
Administrative Law Judge 2,1511,9,Strikeable,9751,10908,11622,1157,1871,25550,117012,139464
Administrative Law Judge 2,1511,10,Strikeable,10242,10908,11622,666,1380,26761,122904,139464
Administrative Law Judge 3,1513,1,Strikeable,8057,8999,10065,942,2008,21372,96684,120780
Administrative Law Judge 3,1513,2,Strikeable,8450,9447,10545,997,2095,22341,101400,126540
Administrative Law Judge 3,1513,3,Strikeable,8870,9897,11065,1027,2195,23377,106440,132780
Administrative Law Judge 3,1513,4,Strikeable,9293,10385,11622,1092,2329,24420,111516,139464
Administrative Law Judge 3,1513,5,Strikeable,9751,10908,12187,1157,2436,25550,117012,146244
Administrative Law Judge 3,1513,6,Strikeable,10242,11438,12785,1196,2543,26761,122904,153420
Administrative Law Judge 3,1513,7,Strikeable,10740,11999,13419,1259,2679,27989,128880,161028
Administrative Law Judge 3,1513,8,Strikeable,11267,12594,14080,1327,2813,29289,135204,168960
Administrative Law Judge 3,1513,9,Strikeable,11825,13215,14080,1390,2255,30665,141900,168960
Administrative Law Judge 3,1513,10,Strikeable,12408,13215,14080,807,1672,32103,148896,168960
Administrative Specialist 1,107,1,Strikeable,3218,3709,4118,491,900,9437,38616,49416
Administrative Specialist 1,107,2,Strikeable,3335,3709,4118,374,783,9726,40020,49416
Administrative Specialist 1,107,3,Strikeable,3483,3865,4301,382,818,10091,41796,51612
Administrative Specialist 1,107,4,Strikeable,3629,4036,4498,407,869,10451,43548,53976
Administrative Specialist 1,107,5,Strikeable,3790,4222,4715,432,925,10848,45480,56580
Administrative Specialist 1,107,6,Strikeable,3964,4425,4943,461,979,11277,47568,59316
Administrative Specialist 1,107,7,Strikeable,4155,4639,5169,484,1014,11748,49860,62028
Administrative Specialist 1,107,8,Strikeable,4356,4851,5420,495,1064,12244,52272,65040
Administrative Specialist 1,107,9,Strikeable,4555,5086,5420,531,865,12735,54660,65040
Administrative Specialist 1,107,10,Strikeable,4776,5086,5420,310,644,13280,57312,65040
Administrative Specialist 2,108,1,Strikeable,3629,4222,4715,593,1086,10451,43548,56580
Administrative Specialist 2,108,2,Strikeable,3790,4222,4715,432,925,10848,45480,56580
Administrative Specialist 2,108,3,Strikeable,3964,4425,4943,461,979,11277,47568,59316
Administrative Specialist 2,108,4,Strikeable,4155,4639,5169,484,1014,11748,49860,62028
Administrative Specialist 2,108,5,Strikeable,4356,4851,5420,495,1064,12244,52272,65040
Administrative Specialist 2,108,6,Strikeable,4555,5086,5695,531,1140,12735,54660,68340
Administrative Specialist 2,108,7,Strikeable,4776,5345,5964,569,1188,13280,57312,71568
Administrative Specialist 2,108,8,Strikeable,5019,5598,6245,579,1226,13879,60228,74940
Administrative Specialist 2,108,9,Strikeable,5256,5861,6245,605,989,14464,63072,74940
Administrative Specialist 2,108,10,Strikeable,5503,5861,6245,358,742,15073,66036,74940
Adult Protective Service Specialist,6616,1,Strikeable,4555,5086,5695,531,1140,12735,54660,68340
Adult Protective Service Specialist,6616,2,Strikeable,4776,5345,5964,569,1188,13280,57312,71568
Adult Protective Service Specialist,6616,3,Strikeable,5019,5598,6245,579,1226,13879,60228,74940
Adult Protective Service Specialist,6616,4,Strikeable,5256,5861,6549,605,1293,14464,63072,78588
Adult Protective Service Specialist,6616,5,Strikeable,5503,6146,6866,643,1363,15073,66036,82392
Adult Protective Service Specialist,6616,6,Strikeable,5771,6444,7206,673,1435,15734,69252,86472
Adult Protective Service Specialist,6616,7,Strikeable,6051,6763,7562,712,1511,16424,72612,90744
Adult Protective Service Specialist,6616,8,Strikeable,6350,7097,7923,747,1573,17162,76200,95076
Adult Protective Service Specialist,6616,9,Strikeable,6664,7436,7923,772,1259,17936,79968,95076
Adult Protective Service Specialist,6616,10,Strikeable,6982,7436,7923,454,941,18721,83784,95076
Aerial Photographer,3540,1,Strikeable,4356,4851,5420,495,1064,12244,52272,65040
Aerial Photographer,3540,2,Strikeable,4555,5086,5695,531,1140,12735,54660,68340
Aerial Photographer,3540,3,Strikeable,4776,5345,5964,569,1188,13280,57312,71568
Aerial Photographer,3540,4,Strikeable,5019,5598,6245,579,1226,13879,60228,74940
Aerial Photographer,3540,5,Strikeable,5256,5861,6549,605,1293,14464,63072,78588
Aerial Photographer,3540,6,Strikeable,5503,6146,6866,643,1363,15073,66036,82392
Aerial Photographer,3540,7,Strikeable,5771,6444,7206,673,1435,15734,69252,86472
Aerial Photographer,3540,8,Strikeable,6051,6763,7562,712,1511,16424,72612,90744
Aerial Photographer,3540,9,Strikeable,6350,7097,7562,747,1212,17162,76200,90744
Aerial Photographer,3540,10,Strikeable,6664,7097,7562,433,898,17936,79968,90744
Aircraft Pilot,8333,1,Strikeable,5019,5598,6245,579,1226,13879,60228,74940
Aircraft Pilot,8333,2,Strikeable,5256,5861,6549,605,1293,14464,63072,78588
Aircraft Pilot,8333,3,Strikeable,5503,6146,6866,643,1363,15073,66036,82392
Aircraft Pilot,8333,4,Strikeable,5771,6444,7206,673,1435,15734,69252,86472
Aircraft Pilot,8333,5,Strikeable,6051,6763,7562,712,1511,16424,72612,90744
Aircraft Pilot,8333,6,Strikeable,6350,7097,7923,747,1573,17162,76200,95076
Aircraft Pilot,8333,7,Strikeable,6664,7436,8314,772,1650,17936,79968,99768
Aircraft Pilot,8333,8,Strikeable,6982,7803,8713,821,1731,18721,83784,104556
Aircraft Pilot,8333,9,Strikeable,7327,8177,8713,850,1386,19571,87924,104556
Aircraft Pilot,8333,10,Strikeable,7678,8177,8713,499,1035,20437,92136,104556
Appraiser Analyst 1,735,1,Strikeable,3335,3865,4301,530,966,9726,40020,51612
Appraiser Analyst 1,735,2,Strikeable,3483,3865,4301,382,818,10091,41796,51612
Appraiser Analyst 1,735,3,Strikeable,3629,4036,4498,407,869,10451,43548,53976
Appraiser Analyst 1,735,4,Strikeable,3790,4222,4715,432,925,10848,45480,56580
Appraiser Analyst 1,735,5,Strikeable,3964,4425,4943,461,979,11277,47568,59316
Appraiser Analyst 1,735,6,Strikeable,4155,4639,5169,484,1014,11748,49860,62028
Appraiser Analyst 1,735,7,Strikeable,4356,4851,5420,495,1064,12244,52272,65040
Appraiser Analyst 1,735,8,Strikeable,4555,5086,5695,531,1140,12735,54660,68340
Appraiser Analyst 1,735,9,Strikeable,4776,5345,5695,569,919,13280,57312,68340
Appraiser Analyst 1,735,10,Strikeable,5019,5345,5695,326,676,13879,60228,68340
Appraiser Analyst 2,736,1,Strikeable,4555,5086,5695,531,1140,12735,54660,68340
Appraiser Analyst 2,736,2,Strikeable,4776,5345,5964,569,1188,13280,57312,71568
Appraiser Analyst 2,736,3,Strikeable,5019,5598,6245,579,1226,13879,60228,74940
Appraiser Analyst 2,736,4,Strikeable,5256,5861,6549,605,1293,14464,63072,78588
Appraiser Analyst 2,736,5,Strikeable,5503,6146,6866,643,1363,15073,66036,82392
Appraiser Analyst 2,736,6,Strikeable,5771,6444,7206,673,1435,15734,69252,86472
Appraiser Analyst 2,736,7,Strikeable,6051,6763,7562,712,1511,16424,72612,90744
Appraiser Analyst 2,736,8,Strikeable,6350,7097,7923,747,1573,17162,76200,95076
Appraiser Analyst 2,736,9,Strikeable,6664,7436,7923,772,1259,17936,79968,95076
Appraiser Analyst 2,736,10,Strikeable,6982,7436,7923,454,941,18721,83784,95076
Appraiser Analyst 3,737,1,Strikeable,5256,5861,6549,605,1293,14464,63072,78588
Appraiser Analyst 3,737,2,Strikeable,5503,6146,6866,643,1363,15073,66036,82392
Appraiser Analyst 3,737,3,Strikeable,5771,6444,7206,673,1435,15734,69252,86472
Appraiser Analyst 3,737,4,Strikeable,6051,6763,7562,712,1511,16424,72612,90744
Appraiser Analyst 3,737,5,Strikeable,6350,7097,7923,747,1573,17162,76200,95076
Appraiser Analyst 3,737,6,Strikeable,6664,7436,8314,772,1650,17936,79968,99768
Appraiser Analyst 3,737,7,Strikeable,6982,7803,8713,821,1731,18721,83784,104556
Appraiser Analyst 3,737,8,Strikeable,7327,8177,9143,850,1816,19571,87924,109716
Appraiser Analyst 3,737,9,Strikeable,7678,8581,9143,903,1465,20437,92136,109716
Appraiser Analyst 3,737,10,Strikeable,8057,8581,9143,524,1086,21372,96684,109716
Appraiser Analyst 4,738,1,Strikeable,6051,6763,7562,712,1511,16424,72612,90744
Appraiser Analyst 4,738,2,Strikeable,6350,7097,7923,747,1573,17162,76200,95076
Appraiser Analyst 4,738,3,Strikeable,6664,7436,8314,772,1650,17936,79968,99768
Appraiser Analyst 4,738,4,Strikeable,6982,7803,8713,821,1731,18721,83784,104556
Appraiser Analyst 4,738,5,Strikeable,7327,8177,9143,850,1816,19571,87924,109716
Appraiser Analyst 4,738,6,Strikeable,7678,8581,9589,903,1911,20437,92136,115068
Appraiser Analyst 4,738,7,Strikeable,8057,8999,10065,942,2008,21372,96684,120780
Appraiser Analyst 4,738,8,Strikeable,8450,9447,10545,997,2095,22341,101400,126540
Appraiser Analyst 4,738,9,Strikeable,8870,9897,10545,1027,1675,23377,106440,126540
Appraiser Analyst 4,738,10,Strikeable,9293,9897,10545,604,1252,24420,111516,126540
Apprenticeship Representative,4380,1,Strikeable,4155,4639,5169,484,1014,11748,49860,62028
Apprenticeship Representative,4380,2,Strikeable,4356,4851,5420,495,1064,12244,52272,65040
Apprenticeship Representative,4380,3,Strikeable,4555,5086,5695,531,1140,12735,54660,68340
Apprenticeship Representative,4380,4,Strikeable,4776,5345,5964,569,1188,13280,57312,71568
Apprenticeship Representative,4380,5,Strikeable,5019,5598,6245,579,1226,13879,60228,74940
Apprenticeship Representative,4380,6,Strikeable,5256,5861,6549,605,1293,14464,63072,78588
Apprenticeship Representative,4380,7,Strikeable,5503,6146,6866,643,1363,15073,66036,82392
Apprenticeship Representative,4380,8,Strikeable,5771,6444,7206,673,1435,15734,69252,86472
Apprenticeship Representative,4380,9,Strikeable,6051,6763,7206,712,1155,16424,72612,86472
Apprenticeship Representative,4380,10,Strikeable,6350,6763,7206,413,856,17162,76200,86472
Automotive Fleet Attendant,4417,1,Strikeable,0,,,,,1500,0,
Automotive Fleet Attendant,4417,2,Strikeable,3005,3427,3784,422,779,8912,36060,45408
Automotive Fleet Attendant,4417,3,Strikeable,3095,3427,3784,332,689,9134,37140,45408
Automotive Fleet Attendant,4417,4,Strikeable,3218,3552,3952,334,734,9437,38616,47424
Automotive Fleet Attendant,4417,5,Strikeable,3335,3709,4118,374,783,9726,40020,49416
Automotive Fleet Attendant,4417,6,Strikeable,3483,3865,4301,382,818,10091,41796,51612
Automotive Fleet Attendant,4417,7,Strikeable,3629,4036,4498,407,869,10451,43548,53976
Automotive Fleet Attendant,4417,8,Strikeable,3790,4222,4715,432,925,10848,45480,56580
Automotive Fleet Attendant,4417,9,Strikeable,3964,4425,4715,461,751,11277,47568,56580
Automotive Fleet Attendant,4417,10,Strikeable,4155,4425,4715,270,560,11748,49860,56580
Automotive Technician 1,4418,1,Strikeable,3483,4036,4498,553,1015,10091,41796,53976
Automotive Technician 1,4418,2,Strikeable,3629,4036,4498,407,869,10451,43548,53976
Automotive Technician 1,4418,3,Strikeable,3790,4222,4715,432,925,10848,45480,56580
Automotive Technician 1,4418,4,Strikeable,3964,4425,4943,461,979,11277,47568,59316
Automotive Technician 1,4418,5,Strikeable,4155,4639,5169,484,1014,11748,49860,62028
Automotive Technician 1,4418,6,Strikeable,4356,4851,5420,495,1064,12244,52272,65040
Automotive Technician 1,4418,7,Strikeable,4555,5086,5695,531,1140,12735,54660,68340
Automotive Technician 1,4418,8,Strikeable,4776,5345,5964,569,1188,13280,57312,71568
Automotive Technician 1,4418,9,Strikeable,5019,5598,5964,579,945,13879,60228,71568
Automotive Technician 1,4418,10,Strikeable,5256,5598,5964,342,708,14464,63072,71568
Automotive Technician 2,4419,1,Strikeable,4155,4639,5169,484,1014,11748,49860,62028
Automotive Technician 2,4419,2,Strikeable,4356,4851,5420,495,1064,12244,52272,65040
Automotive Technician 2,4419,3,Strikeable,4555,5086,5695,531,1140,12735,54660,68340
Automotive Technician 2,4419,4,Strikeable,4776,5345,5964,569,1188,13280,57312,71568
Automotive Technician 2,4419,5,Strikeable,5019,5598,6245,579,1226,13879,60228,74940
Automotive Technician 2,4419,6,Strikeable,5256,5861,6549,605,1293,14464,63072,78588
Automotive Technician 2,4419,7,Strikeable,5503,6146,6866,643,1363,15073,66036,82392
Automotive Technician 2,4419,8,Strikeable,5771,6444,7206,673,1435,15734,69252,86472
Automotive Technician 2,4419,9,Strikeable,6051,6763,7206,712,1155,16424,72612,86472
Automotive Technician 2,4419,10,Strikeable,6350,6763,7206,413,856,17162,76200,86472
Behavioral Health Specialist 1,6531,1,Strikeable,4356,4851,5420,495,1064,12244,52272,65040
Behavioral Health Specialist 1,6531,2,Strikeable,4555,5086,5695,531,1140,12735,54660,68340
Behavioral Health Specialist 1,6531,3,Strikeable,4776,5345,5964,569,1188,13280,57312,71568
Behavioral Health Specialist 1,6531,4,Strikeable,5019,5598,6245,579,1226,13879,60228,74940
Behavioral Health Specialist 1,6531,5,Strikeable,5256,5861,6549,605,1293,14464,63072,78588
Behavioral Health Specialist 1,6531,6,Strikeable,5503,6146,6866,643,1363,15073,66036,82392
Behavioral Health Specialist 1,6531,7,Strikeable,5771,6444,7206,673,1435,15734,69252,86472
Behavioral Health Specialist 1,6531,8,Strikeable,6051,6763,7562,712,1511,16424,72612,90744
Behavioral Health Specialist 1,6531,9,Strikeable,6350,7097,7562,747,1212,17162,76200,90744
Behavioral Health Specialist 1,6531,10,Strikeable,6664,7097,7562,433,898,17936,79968,90744
Behavioral Health Specialist 2,6534,1,Strikeable,5019,5598,6245,579,1226,13879,60228,74940
Behavioral Health Specialist 2,6534,2,Strikeable,5256,5861,6549,605,1293,14464,63072,78588
Behavioral Health Specialist 2,6534,3,Strikeable,5503,6146,6866,643,1363,15073,66036,82392
Behavioral Health Specialist 2,6534,4,Strikeable,5771,6444,7206,673,1435,15734,69252,86472
Behavioral Health Specialist 2,6534,5,Strikeable,6051,6763,7562,712,1511,16424,72612,90744
Behavioral Health Specialist 2,6534,6,Strikeable,6350,7097,7923,747,1573,17162,76200,95076
Behavioral Health Specialist 2,6534,7,Strikeable,6664,7436,8314,772,1650,17936,79968,99768
Behavioral Health Specialist 2,6534,8,Strikeable,6982,7803,8713,821,1731,18721,83784,104556
Behavioral Health Specialist 2,6534,9,Strikeable,7327,8177,8713,850,1386,19571,87924,104556
Behavioral Health Specialist 2,6534,10,Strikeable,7678,8177,8713,499,1035,20437,92136,104556
Behavioral Health Specialist 3,6535,1,Strikeable,5503,6146,6866,643,1363,15073,66036,82392
Behavioral Health Specialist 3,6535,2,Strikeable,5771,6444,7206,673,1435,15734,69252,86472
Behavioral Health Specialist 3,6535,3,Strikeable,6051,6763,7562,712,1511,16424,72612,90744
Behavioral Health Specialist 3,6535,4,Strikeable,6350,7097,7923,747,1573,17162,76200,95076
Behavioral Health Specialist 3,6535,5,Strikeable,6664,7436,8314,772,1650,17936,79968,99768
Behavioral Health Specialist 3,6535,6,Strikeable,6982,7803,8713,821,1731,18721,83784,104556
Behavioral Health Specialist 3,6535,7,Strikeable,7327,8177,9143,850,1816,19571,87924,109716
Behavioral Health Specialist 3,6535,8,Strikeable,7678,8581,9589,903,1911,20437,92136,115068
Behavioral Health Specialist 3,6535,9,Strikeable,8057,8999,9589,942,1532,21372,96684,115068
Behavioral Health Specialist 3,6535,10,Strikeable,8450,8999,9589,549,1139,22341,101400,115068
Biological Science Assistant,3769,1,Strikeable,0,,,,,1500,0,
Biological Science Assistant,3769,2,Strikeable,0,,,,,1500,0,
Biological Science Assistant,3769,3,Strikeable,0,,,,,1500,0,
Biological Science Assistant,3769,4,Strikeable,3005,3427,3784,422,779,8912,36060,45408
Biological Science Assistant,3769,5,Strikeable,3095,3427,3784,332,689,9134,37140,45408
Biological Science Assistant,3769,6,Strikeable,3218,3552,3952,334,734,9437,38616,47424
Biological Science Assistant,3769,7,Strikeable,3335,3709,4118,374,783,9726,40020,49416
Biological Science Assistant,3769,8,Strikeable,3483,3865,4301,382,818,10091,41796,51612
Biological Science Assistant,3769,9,Strikeable,3629,4036,4301,407,672,10451,43548,51612
Biological Science Assistant,3769,10,Strikeable,3790,4036,4301,246,511,10848,45480,51612
Business & Employment Specialist 2,6699,1,Strikeable,3790,4222,4715,432,925,10848,45480,56580
Business & Employment Specialist 2,6699,2,Strikeable,3964,4425,4943,461,979,11277,47568,59316
Business & Employment Specialist 2,6699,3,Strikeable,4155,4639,5169,484,1014,11748,49860,62028
Business & Employment Specialist 2,6699,4,Strikeable,4356,4851,5420,495,1064,12244,52272,65040
Business & Employment Specialist 2,6699,5,Strikeable,4555,5086,5695,531,1140,12735,54660,68340
Business & Employment Specialist 2,6699,6,Strikeable,4776,5345,5964,569,1188,13280,57312,71568
Business & Employment Specialist 2,6699,7,Strikeable,5019,5598,6245,579,1226,13879,60228,74940
Business & Employment Specialist 2,6699,8,Strikeable,5256,5861,6549,605,1293,14464,63072,78588
Business & Employment Specialist 2,6699,9,Strikeable,5503,6146,6549,643,1046,15073,66036,78588
Business & Employment Specialist 2,6699,10,Strikeable,5771,6146,6549,375,778,15734,69252,78588
Carpenter,4003,1,Strikeable,3964,4425,4943,461,979,11277,47568,59316
Carpenter,4003,2,Strikeable,4155,4639,5169,484,1014,11748,49860,62028
Carpenter,4003,3,Strikeable,4356,4851,5420,495,1064,12244,52272,65040
Carpenter,4003,4,Strikeable,4555,5086,5695,531,1140,12735,54660,68340
Carpenter,4003,5,Strikeable,4776,5345,5964,569,1188,13280,57312,71568
Carpenter,4003,6,Strikeable,5019,5598,6245,579,1226,13879,60228,74940
Carpenter,4003,7,Strikeable,5256,5861,6549,605,1293,14464,63072,78588
Carpenter,4003,8,Strikeable,5503,6146,6866,643,1363,15073,66036,82392
Carpenter,4003,9,Strikeable,5771,6444,6866,673,1095,15734,69252,82392
Carpenter,4003,10,Strikeable,6051,6444,6866,393,815,16424,72612,82392
Certified Occupation Therapist Assistant,6506,1,Strikeable,3629,4425,4943,796,1314,10451,43548,59316
Certified Occupation Therapist Assistant,6506,2,Strikeable,3790,4425,4943,635,1153,10848,45480,59316
Certified Occupation Therapist Assistant,6506,3,Strikeable,3964,4425,4943,461,979,11277,47568,59316
Certified Occupation Therapist Assistant,6506,4,Strikeable,4155,4639,5169,484,1014,11748,49860,62028
Certified Occupation Therapist Assistant,6506,5,Strikeable,4356,4851,5420,495,1064,12244,52272,65040
Certified Occupation Therapist Assistant,6506,6,Strikeable,4555,5086,5695,531,1140,12735,54660,68340
Certified Occupation Therapist Assistant,6506,7,Strikeable,4776,5345,5964,569,1188,13280,57312,71568
Certified Occupation Therapist Assistant,6506,8,Strikeable,5019,5598,6245,579,1226,13879,60228,74940
Certified Occupation Therapist Assistant,6506,9,Strikeable,5256,5861,6245,605,989,14464,63072,74940
Certified Occupation Therapist Assistant,6506,10,Strikeable,5503,5861,6245,358,742,15073,66036,74940
Chaplain,6680,1,Strikeable,4356,4851,5420,495,1064,12244,52272,65040
Chaplain,6680,2,Strikeable,4555,5086,5695,531,1140,12735,54660,68340
Chaplain,6680,3,Strikeable,4776,5345,5964,569,1188,13280,57312,71568
Chaplain,6680,4,Strikeable,5019,5598,6245,579,1226,13879,60228,74940
Chaplain,6680,5,Strikeable,5256,5861,6549,605,1293,14464,63072,78588
Chaplain,6680,6,Strikeable,5503,6146,6866,643,1363,15073,66036,82392
Chaplain,6680,7,Strikeable,5771,6444,7206,673,1435,15734,69252,86472
Chaplain,6680,8,Strikeable,6051,6763,7562,712,1511,16424,72612,90744
Chaplain,6680,9,Strikeable,6350,7097,7562,747,1212,17162,76200,90744
Chaplain,6680,10,Strikeable,6664,7097,7562,433,898,17936,79968,90744
Chemist 1,3715,1,Strikeable,4356,4851,5420,495,1064,12244,52272,65040
Chemist 1,3715,2,Strikeable,4555,5086,5695,531,1140,12735,54660,68340
Chemist 1,3715,3,Strikeable,4776,5345,5964,569,1188,13280,57312,71568
Chemist 1,3715,4,Strikeable,5019,5598,6245,579,1226,13879,60228,74940
Chemist 1,3715,5,Strikeable,5256,5861,6549,605,1293,14464,63072,78588
Chemist 1,3715,6,Strikeable,5503,6146,6866,643,1363,15073,66036,82392
Chemist 1,3715,7,Strikeable,5771,6444,7206,673,1435,15734,69252,86472
Chemist 1,3715,8,Strikeable,6051,6763,7562,712,1511,16424,72612,90744
Chemist 1,3715,9,Strikeable,6350,7097,7562,747,1212,17162,76200,90744
Chemist 1,3715,10,Strikeable,6664,7097,7562,433,898,17936,79968,90744
Chemist 2,3716,1,Strikeable,4776,5345,5964,569,1188,13280,57312,71568
Chemist 2,3716,2,Strikeable,5019,5598,6245,579,1226,13879,60228,74940
Chemist 2,3716,3,Strikeable,5256,5861,6549,605,1293,14464,63072,78588
Chemist 2,3716,4,Strikeable,5503,6146,6866,643,1363,15073,66036,82392
Chemist 2,3716,5,Strikeable,5771,6444,7206,673,1435,15734,69252,86472
Chemist 2,3716,6,Strikeable,6051,6763,7562,712,1511,16424,72612,90744
Chemist 2,3716,7,Strikeable,6350,7097,7923,747,1573,17162,76200,95076
Chemist 2,3716,8,Strikeable,6664,7436,8314,772,1650,17936,79968,99768
Chemist 2,3716,9,Strikeable,6982,7803,8314,821,1332,18721,83784,99768
Chemist 2,3716,10,Strikeable,7327,7803,8314,476,987,19571,87924,99768
Chemist 3,3717,1,Strikeable,5503,6146,6866,643,1363,15073,66036,82392
Chemist 3,3717,2,Strikeable,5771,6444,7206,673,1435,15734,69252,86472
Chemist 3,3717,3,Strikeable,6051,6763,7562,712,1511,16424,72612,90744
Chemist 3,3717,4,Strikeable,6350,7097,7923,747,1573,17162,76200,95076
Chemist 3,3717,5,Strikeable,6664,7436,8314,772,1650,17936,79968,99768
Chemist 3,3717,6,Strikeable,6982,7803,8713,821,1731,18721,83784,104556
Chemist 3,3717,7,Strikeable,7327,8177,9143,850,1816,19571,87924,109716
Chemist 3,3717,8,Strikeable,7678,8581,9589,903,1911,20437,92136,115068
Chemist 3,3717,9,Strikeable,8057,8999,9589,942,1532,21372,96684,115068
Chemist 3,3717,10,Strikeable,8450,8999,9589,549,1139,22341,101400,115068
Child Nutrition Specialist,5950,1,Strikeable,5256,5861,6549,605,1293,14464,63072,78588
Child Nutrition Specialist,5950,2,Strikeable,5503,6146,6866,643,1363,15073,66036,82392
Child Nutrition Specialist,5950,3,Strikeable,5771,6444,7206,673,1435,15734,69252,86472
Child Nutrition Specialist,5950,4,Strikeable,6051,6763,7562,712,1511,16424,72612,90744
Child Nutrition Specialist,5950,5,Strikeable,6350,7097,7923,747,1573,17162,76200,95076
Child Nutrition Specialist,5950,6,Strikeable,6664,7436,8314,772,1650,17936,79968,99768
Child Nutrition Specialist,5950,7,Strikeable,6982,7803,8713,821,1731,18721,83784,104556
Child Nutrition Specialist,5950,8,Strikeable,7327,8177,9143,850,1816,19571,87924,109716
Child Nutrition Specialist,5950,9,Strikeable,7678,8581,9143,903,1465,20437,92136,109716
Child Nutrition Specialist,5950,10,Strikeable,8057,8581,9143,524,1086,21372,96684,109716
Child Support Case Manager,5139,1,Strikeable,3790,4425,4943,635,1153,10848,45480,59316
Child Support Case Manager,5139,2,Strikeable,3964,4425,4943,461,979,11277,47568,59316
Child Support Case Manager,5139,3,Strikeable,4155,4639,5169,484,1014,11748,49860,62028
Child Support Case Manager,5139,4,Strikeable,4356,4851,5420,495,1064,12244,52272,65040
Child Support Case Manager,5139,5,Strikeable,4555,5086,5695,531,1140,12735,54660,68340
Child Support Case Manager,5139,6,Strikeable,4776,5345,5964,569,1188,13280,57312,71568
Child Support Case Manager,5139,7,Strikeable,5019,5598,6245,579,1226,13879,60228,74940
Child Support Case Manager,5139,8,Strikeable,5256,5861,6549,605,1293,14464,63072,78588
Child Support Case Manager,5139,9,Strikeable,5503,6146,6549,643,1046,15073,66036,78588
Child Support Case Manager,5139,10,Strikeable,5771,6146,6549,375,778,15734,69252,78588
Child Support Case Manager Entry,5138,1,Strikeable,3483,4036,4498,553,1015,10091,41796,53976
Child Support Case Manager Entry,5138,2,Strikeable,3629,4036,4498,407,869,10451,43548,53976
Child Support Case Manager Entry,5138,3,Strikeable,3790,4222,4715,432,925,10848,45480,56580
Child Support Case Manager Entry,5138,4,Strikeable,3964,4425,4943,461,979,11277,47568,59316
Child Support Case Manager Entry,5138,5,Strikeable,4155,4639,5169,484,1014,11748,49860,62028
Child Support Case Manager Entry,5138,6,Strikeable,4356,4851,5420,495,1064,12244,52272,65040
Child Support Case Manager Entry,5138,7,Strikeable,4555,5086,5695,531,1140,12735,54660,68340
Child Support Case Manager Entry,5138,8,Strikeable,4776,5345,5964,569,1188,13280,57312,71568
Child Support Case Manager Entry,5138,9,Strikeable,5019,5598,5964,579,945,13879,60228,71568
Child Support Case Manager Entry,5138,10,Strikeable,5256,5598,5964,342,708,14464,63072,71568
Child Support Specialist,5133,1,Strikeable,4155,4639,5169,484,1014,11748,49860,62028
Child Support Specialist,5133,2,Strikeable,4356,4851,5420,495,1064,12244,52272,65040
Child Support Specialist,5133,3,Strikeable,4555,5086,5695,531,1140,12735,54660,68340
Child Support Specialist,5133,4,Strikeable,4776,5345,5964,569,1188,13280,57312,71568
Child Support Specialist,5133,5,Strikeable,5019,5598,6245,579,1226,13879,60228,74940
Child Support Specialist,5133,6,Strikeable,5256,5861,6549,605,1293,14464,63072,78588
Child Support Specialist,5133,7,Strikeable,5503,6146,6866,643,1363,15073,66036,82392
Child Support Specialist,5133,8,Strikeable,5771,6444,7206,673,1435,15734,69252,86472
Child Support Specialist,5133,9,Strikeable,6051,6763,7206,712,1155,16424,72612,86472
Child Support Specialist,5133,10,Strikeable,6350,6763,7206,413,856,17162,76200,86472
Civil Engineering Specialist 1,3136,1,Strikeable,4555,5086,5695,531,1140,12735,54660,68340
Civil Engineering Specialist 1,3136,2,Strikeable,4776,5345,5964,569,1188,13280,57312,71568
Civil Engineering Specialist 1,3136,3,Strikeable,5019,5598,6245,579,1226,13879,60228,74940
Civil Engineering Specialist 1,3136,4,Strikeable,5256,5861,6549,605,1293,14464,63072,78588
Civil Engineering Specialist 1,3136,5,Strikeable,5503,6146,6866,643,1363,15073,66036,82392
Civil Engineering Specialist 1,3136,6,Strikeable,5771,6444,7206,673,1435,15734,69252,86472
Civil Engineering Specialist 1,3136,7,Strikeable,6051,6763,7562,712,1511,16424,72612,90744
Civil Engineering Specialist 1,3136,8,Strikeable,6350,7097,7923,747,1573,17162,76200,95076
Civil Engineering Specialist 1,3136,9,Strikeable,6664,7436,7923,772,1259,17936,79968,95076
Civil Engineering Specialist 1,3136,10,Strikeable,6982,7436,7923,454,941,18721,83784,95076
Civil Rights Investigator 1,5340,1,Strikeable,3790,4425,4943,635,1153,10848,45480,59316
Civil Rights Investigator 1,5340,2,Strikeable,3964,4425,4943,461,979,11277,47568,59316
Civil Rights Investigator 1,5340,3,Strikeable,4155,4639,5169,484,1014,11748,49860,62028
Civil Rights Investigator 1,5340,4,Strikeable,4356,4851,5420,495,1064,12244,52272,65040
Civil Rights Investigator 1,5340,5,Strikeable,4555,5086,5695,531,1140,12735,54660,68340
Civil Rights Investigator 1,5340,6,Strikeable,4776,5345,5964,569,1188,13280,57312,71568
Civil Rights Investigator 1,5340,7,Strikeable,5019,5598,6245,579,1226,13879,60228,74940
Civil Rights Investigator 1,5340,8,Strikeable,5256,5861,6549,605,1293,14464,63072,78588
Civil Rights Investigator 1,5340,9,Strikeable,5503,6146,6549,643,1046,15073,66036,78588
Civil Rights Investigator 1,5340,10,Strikeable,5771,6146,6549,375,778,15734,69252,78588
Civil Rights Investigator 2,5341,1,Strikeable,4776,5345,5964,569,1188,13280,57312,71568
Civil Rights Investigator 2,5341,2,Strikeable,5019,5598,6245,579,1226,13879,60228,74940
Civil Rights Investigator 2,5341,3,Strikeable,5256,5861,6549,605,1293,14464,63072,78588
Civil Rights Investigator 2,5341,4,Strikeable,5503,6146,6866,643,1363,15073,66036,82392
Civil Rights Investigator 2,5341,5,Strikeable,5771,6444,7206,673,1435,15734,69252,86472
Civil Rights Investigator 2,5341,6,Strikeable,6051,6763,7562,712,1511,16424,72612,90744
Civil Rights Investigator 2,5341,7,Strikeable,6350,7097,7923,747,1573,17162,76200,95076
Civil Rights Investigator 2,5341,8,Strikeable,6664,7436,8314,772,1650,17936,79968,99768
Civil Rights Investigator 2,5341,9,Strikeable,6982,7803,8314,821,1332,18721,83784,99768
Civil Rights Investigator 2,5341,10,Strikeable,7327,7803,8314,476,987,19571,87924,99768
Claims Representative 1,5307,1,Strikeable,3964,4425,4943,461,979,11277,47568,59316
Claims Representative 1,5307,2,Strikeable,4155,4639,5169,484,1014,11748,49860,62028
Claims Representative 1,5307,3,Strikeable,4356,4851,5420,495,1064,12244,52272,65040
Claims Representative 1,5307,4,Strikeable,4555,5086,5695,531,1140,12735,54660,68340
Claims Representative 1,5307,5,Strikeable,4776,5345,5964,569,1188,13280,57312,71568
Claims Representative 1,5307,6,Strikeable,5019,5598,6245,579,1226,13879,60228,74940
Claims Representative 1,5307,7,Strikeable,5256,5861,6549,605,1293,14464,63072,78588
Claims Representative 1,5307,8,Strikeable,5503,6146,6866,643,1363,15073,66036,82392
Claims Representative 1,5307,9,Strikeable,5771,6444,6866,673,1095,15734,69252,82392
Claims Representative 1,5307,10,Strikeable,6051,6444,6866,393,815,16424,72612,82392
Claims Representative 2,5308,1,Strikeable,4356,4851,5420,495,1064,12244,52272,65040
Claims Representative 2,5308,2,Strikeable,4555,5086,5695,531,1140,12735,54660,68340
Claims Representative 2,5308,3,Strikeable,4776,5345,5964,569,1188,13280,57312,71568
Claims Representative 2,5308,4,Strikeable,5019,5598,6245,579,1226,13879,60228,74940
Claims Representative 2,5308,5,Strikeable,5256,5861,6549,605,1293,14464,63072,78588
Claims Representative 2,5308,6,Strikeable,5503,6146,6866,643,1363,15073,66036,82392
Claims Representative 2,5308,7,Strikeable,5771,6444,7206,673,1435,15734,69252,86472
Claims Representative 2,5308,8,Strikeable,6051,6763,7562,712,1511,16424,72612,90744
Claims Representative 2,5308,9,Strikeable,6350,7097,7562,747,1212,17162,76200,90744
Claims Representative 2,5308,10,Strikeable,6664,7097,7562,433,898,17936,79968,90744
Client Care Surveyor,6685,1,Strikeable,5256,5861,6549,605,1293,14464,63072,78588
Client Care Surveyor,6685,2,Strikeable,5503,6146,6866,643,1363,15073,66036,82392
Client Care Surveyor,6685,3,Strikeable,5771,6444,7206,673,1435,15734,69252,86472
Client Care Surveyor,6685,4,Strikeable,6051,6763,7562,712,1511,16424,72612,90744
Client Care Surveyor,6685,5,Strikeable,6350,7097,7923,747,1573,17162,76200,95076
Client Care Surveyor,6685,6,Strikeable,6664,7436,8314,772,1650,17936,79968,99768
Client Care Surveyor,6685,7,Strikeable,6982,7803,8713,821,1731,18721,83784,104556
Client Care Surveyor,6685,8,Strikeable,7327,8177,9143,850,1816,19571,87924,109716
Client Care Surveyor,6685,9,Strikeable,7678,8581,9143,903,1465,20437,92136,109716
Client Care Surveyor,6685,10,Strikeable,8057,8581,9143,524,1086,21372,96684,109716
Clinical Laboratory Scientist,6833,1,Strikeable,4356,4851,5420,495,1064,12244,52272,65040
Clinical Laboratory Scientist,6833,2,Strikeable,4555,5086,5695,531,1140,12735,54660,68340
Clinical Laboratory Scientist,6833,3,Strikeable,4776,5345,5964,569,1188,13280,57312,71568
Clinical Laboratory Scientist,6833,4,Strikeable,5019,5598,6245,579,1226,13879,60228,74940
Clinical Laboratory Scientist,6833,5,Strikeable,5256,5861,6549,605,1293,14464,63072,78588
Clinical Laboratory Scientist,6833,6,Strikeable,5503,6146,6866,643,1363,15073,66036,82392
Clinical Laboratory Scientist,6833,7,Strikeable,5771,6444,7206,673,1435,15734,69252,86472
Clinical Laboratory Scientist,6833,8,Strikeable,6051,6763,7562,712,1511,16424,72612,90744
Clinical Laboratory Scientist,6833,9,Strikeable,6350,7097,7562,747,1212,17162,76200,90744
Clinical Laboratory Scientist,6833,10,Strikeable,6664,7097,7562,433,898,17936,79968,90744
Clinical Psychologist 1,6394,1,Strikeable,6664,7436,8314,772,1650,17936,79968,99768
Clinical Psychologist 1,6394,2,Strikeable,6982,7803,8713,821,1731,18721,83784,104556
Clinical Psychologist 1,6394,3,Strikeable,7327,8177,9143,850,1816,19571,87924,109716
Clinical Psychologist 1,6394,4,Strikeable,7678,8581,9589,903,1911,20437,92136,115068
Clinical Psychologist 1,6394,5,Strikeable,8057,8999,10065,942,2008,21372,96684,120780
Clinical Psychologist 1,6394,6,Strikeable,8450,9447,10545,997,2095,22341,101400,126540
Clinical Psychologist 1,6394,7,Strikeable,8870,9897,11065,1027,2195,23377,106440,132780
Clinical Psychologist 1,6394,8,Strikeable,9293,10385,11622,1092,2329,24420,111516,139464
Clinical Psychologist 1,6394,9,Strikeable,9751,10908,11622,1157,1871,25550,117012,139464
Clinical Psychologist 1,6394,10,Strikeable,10242,10908,11622,666,1380,26761,122904,139464
Clinical Psychologist 2,6395,1,Strikeable,7327,8177,9143,850,1816,19571,87924,109716
Clinical Psychologist 2,6395,2,Strikeable,7678,8581,9589,903,1911,20437,92136,115068
Clinical Psychologist 2,6395,3,Strikeable,8057,8999,10065,942,2008,21372,96684,120780
Clinical Psychologist 2,6395,4,Strikeable,8450,9447,10545,997,2095,22341,101400,126540
Clinical Psychologist 2,6395,5,Strikeable,8870,9897,11065,1027,2195,23377,106440,132780
Clinical Psychologist 2,6395,6,Strikeable,9293,10385,11622,1092,2329,24420,111516,139464
Clinical Psychologist 2,6395,7,Strikeable,9751,10908,12187,1157,2436,25550,117012,146244
Clinical Psychologist 2,6395,8,Strikeable,10242,11438,12785,1196,2543,26761,122904,153420
Clinical Psychologist 2,6395,9,Strikeable,10740,11999,12785,1259,2045,27989,128880,153420
Clinical Psychologist 2,6395,10,Strikeable,11267,11999,12785,732,1518,29289,135204,153420
Communicable Disease Analyst,5903,1,Strikeable,3964,4425,4943,461,979,11277,47568,59316
Communicable Disease Analyst,5903,2,Strikeable,4155,4639,5169,484,1014,11748,49860,62028
Communicable Disease Analyst,5903,3,Strikeable,4356,4851,5420,495,1064,12244,52272,65040
Communicable Disease Analyst,5903,4,Strikeable,4555,5086,5695,531,1140,12735,54660,68340
Communicable Disease Analyst,5903,5,Strikeable,4776,5345,5964,569,1188,13280,57312,71568
Communicable Disease Analyst,5903,6,Strikeable,5019,5598,6245,579,1226,13879,60228,74940
Communicable Disease Analyst,5903,7,Strikeable,5256,5861,6549,605,1293,14464,63072,78588
Communicable Disease Analyst,5903,8,Strikeable,5503,6146,6866,643,1363,15073,66036,82392
Communicable Disease Analyst,5903,9,Strikeable,5771,6444,6866,673,1095,15734,69252,82392
Communicable Disease Analyst,5903,10,Strikeable,6051,6444,6866,393,815,16424,72612,82392
Community Outreach Specialist,6614,1,Strikeable,4776,5345,5964,569,1188,13280,57312,71568
Community Outreach Specialist,6614,2,Strikeable,5019,5598,6245,579,1226,13879,60228,74940
Community Outreach Specialist,6614,3,Strikeable,5256,5861,6549,605,1293,14464,63072,78588
Community Outreach Specialist,6614,4,Strikeable,5503,6146,6866,643,1363,15073,66036,82392
Community Outreach Specialist,6614,5,Strikeable,5771,6444,7206,673,1435,15734,69252,86472
Community Outreach Specialist,6614,6,Strikeable,6051,6763,7562,712,1511,16424,72612,90744
Community Outreach Specialist,6614,7,Strikeable,6350,7097,7923,747,1573,17162,76200,95076
Community Outreach Specialist,6614,8,Strikeable,6664,7436,8314,772,1650,17936,79968,99768
Community Outreach Specialist,6614,9,Strikeable,6982,7803,8314,821,1332,18721,83784,99768
Community Outreach Specialist,6614,10,Strikeable,7327,7803,8314,476,987,19571,87924,99768
Compliance Specialist 1,5346,1,Strikeable,3790,4425,4943,635,1153,10848,45480,59316
Compliance Specialist 1,5346,2,Strikeable,3964,4425,4943,461,979,11277,47568,59316
Compliance Specialist 1,5346,3,Strikeable,4155,4639,5169,484,1014,11748,49860,62028
Compliance Specialist 1,5346,4,Strikeable,4356,4851,5420,495,1064,12244,52272,65040
Compliance Specialist 1,5346,5,Strikeable,4555,5086,5695,531,1140,12735,54660,68340
Compliance Specialist 1,5346,6,Strikeable,4776,5345,5964,569,1188,13280,57312,71568
Compliance Specialist 1,5346,7,Strikeable,5019,5598,6245,579,1226,13879,60228,74940
Compliance Specialist 1,5346,8,Strikeable,5256,5861,6549,605,1293,14464,63072,78588
Compliance Specialist 1,5346,9,Strikeable,5503,6146,6549,643,1046,15073,66036,78588
Compliance Specialist 1,5346,10,Strikeable,5771,6146,6549,375,778,15734,69252,78588
Compliance Specialist 2,5347,1,Strikeable,4555,5086,5695,531,1140,12735,54660,68340
Compliance Specialist 2,5347,2,Strikeable,4776,5345,5964,569,1188,13280,57312,71568
Compliance Specialist 2,5347,3,Strikeable,5019,5598,6245,579,1226,13879,60228,74940
Compliance Specialist 2,5347,4,Strikeable,5256,5861,6549,605,1293,14464,63072,78588
Compliance Specialist 2,5347,5,Strikeable,5503,6146,6866,643,1363,15073,66036,82392
Compliance Specialist 2,5347,6,Strikeable,5771,6444,7206,673,1435,15734,69252,86472
Compliance Specialist 2,5347,7,Strikeable,6051,6763,7562,712,1511,16424,72612,90744
Compliance Specialist 2,5347,8,Strikeable,6350,7097,7923,747,1573,17162,76200,95076
Compliance Specialist 2,5347,9,Strikeable,6664,7436,7923,772,1259,17936,79968,95076
Compliance Specialist 2,5347,10,Strikeable,6982,7436,7923,454,941,18721,83784,95076
Compliance Specialist 3,5348,1,Strikeable,5503,6146,6866,643,1363,15073,66036,82392
Compliance Specialist 3,5348,2,Strikeable,5771,6444,7206,673,1435,15734,69252,86472
Compliance Specialist 3,5348,3,Strikeable,6051,6763,7562,712,1511,16424,72612,90744
Compliance Specialist 3,5348,4,Strikeable,6350,7097,7923,747,1573,17162,76200,95076
Compliance Specialist 3,5348,5,Strikeable,6664,7436,8314,772,1650,17936,79968,99768
Compliance Specialist 3,5348,6,Strikeable,6982,7803,8713,821,1731,18721,83784,104556
Compliance Specialist 3,5348,7,Strikeable,7327,8177,9143,850,1816,19571,87924,109716
Compliance Specialist 3,5348,8,Strikeable,7678,8581,9589,903,1911,20437,92136,115068
Compliance Specialist 3,5348,9,Strikeable,8057,8999,9589,942,1532,21372,96684,115068
Compliance Specialist 3,5348,10,Strikeable,8450,8999,9589,549,1139,22341,101400,115068
Construction Inspector,3365,1,Strikeable,5019,5598,6245,579,1226,13879,60228,74940
Construction Inspector,3365,2,Strikeable,5256,5861,6549,605,1293,14464,63072,78588
Construction Inspector,3365,3,Strikeable,5503,6146,6866,643,1363,15073,66036,82392
Construction Inspector,3365,4,Strikeable,5771,6444,7206,673,1435,15734,69252,86472
Construction Inspector,3365,5,Strikeable,6051,6763,7562,712,1511,16424,72612,90744
Construction Inspector,3365,6,Strikeable,6350,7097,7923,747,1573,17162,76200,95076
Construction Inspector,3365,7,Strikeable,6664,7436,8314,772,1650,17936,79968,99768
Construction Inspector,3365,8,Strikeable,6982,7803,8713,821,1731,18721,83784,104556
Construction Inspector,3365,9,Strikeable,7327,8177,8713,850,1386,19571,87924,104556
Construction Inspector,3365,10,Strikeable,7678,8177,8713,499,1035,20437,92136,104556
Construction Project Manager 1,3367,1,Strikeable,5019,5598,6245,579,1226,13879,60228,74940
Construction Project Manager 1,3367,2,Strikeable,5256,5861,6549,605,1293,14464,63072,78588
Construction Project Manager 1,3367,3,Strikeable,5503,6146,6866,643,1363,15073,66036,82392
Construction Project Manager 1,3367,4,Strikeable,5771,6444,7206,673,1435,15734,69252,86472
Construction Project Manager 1,3367,5,Strikeable,6051,6763,7562,712,1511,16424,72612,90744
Construction Project Manager 1,3367,6,Strikeable,6350,7097,7923,747,1573,17162,76200,95076
Construction Project Manager 1,3367,7,Strikeable,6664,7436,8314,772,1650,17936,79968,99768
Construction Project Manager 1,3367,8,Strikeable,6982,7803,8713,821,1731,18721,83784,104556
Construction Project Manager 1,3367,9,Strikeable,7327,8177,8713,850,1386,19571,87924,104556
Construction Project Manager 1,3367,10,Strikeable,7678,8177,8713,499,1035,20437,92136,104556
Construction Project Manager 2,3368,1,Strikeable,5771,6444,7206,673,1435,15734,69252,86472
Construction Project Manager 2,3368,2,Strikeable,6051,6763,7562,712,1511,16424,72612,90744
Construction Project Manager 2,3368,3,Strikeable,6350,7097,7923,747,1573,17162,76200,95076
Construction Project Manager 2,3368,4,Strikeable,6664,7436,8314,772,1650,17936,79968,99768
Construction Project Manager 2,3368,5,Strikeable,6982,7803,8713,821,1731,18721,83784,104556
Construction Project Manager 2,3368,6,Strikeable,7327,8177,9143,850,1816,19571,87924,109716
Construction Project Manager 2,3368,7,Strikeable,7678,8581,9589,903,1911,20437,92136,115068
Construction Project Manager 2,3368,8,Strikeable,8057,8999,10065,942,2008,21372,96684,120780
Construction Project Manager 2,3368,9,Strikeable,8450,9447,10065,997,1615,22341,101400,120780
Construction Project Manager 2,3368,10,Strikeable,8870,9447,10065,577,1195,23377,106440,120780
Construction Project Manager 3,3369,1,Strikeable,6664,7436,8314,772,1650,17936,79968,99768
Construction Project Manager 3,3369,2,Strikeable,6982,7803,8713,821,1731,18721,83784,104556
Construction Project Manager 3,3369,3,Strikeable,7327,8177,9143,850,1816,19571,87924,109716
Construction Project Manager 3,3369,4,Strikeable,7678,8581,9589,903,1911,20437,92136,115068
Construction Project Manager 3,3369,5,Strikeable,8057,8999,10065,942,2008,21372,96684,120780
Construction Project Manager 3,3369,6,Strikeable,8450,9447,10545,997,2095,22341,101400,126540
Construction Project Manager 3,3369,7,Strikeable,8870,9897,11065,1027,2195,23377,106440,132780
Construction Project Manager 3,3369,8,Strikeable,9293,10385,11622,1092,2329,24420,111516,139464
Construction Project Manager 3,3369,9,Strikeable,9751,10908,11622,1157,1871,25550,117012,139464
Construction Project Manager 3,3369,10,Strikeable,10242,10908,11622,666,1380,26761,122904,139464
Cook,9117,1,Strikeable,3218,3709,4118,491,900,9437,38616,49416
Cook,9117,2,Strikeable,3335,3709,4118,374,783,9726,40020,49416
Cook,9117,3,Strikeable,3483,3865,4301,382,818,10091,41796,51612
Cook,9117,4,Strikeable,3629,4036,4498,407,869,10451,43548,53976
Cook,9117,5,Strikeable,3790,4222,4715,432,925,10848,45480,56580
Cook,9117,6,Strikeable,3964,4425,4943,461,979,11277,47568,59316
Cook,9117,7,Strikeable,4155,4639,5169,484,1014,11748,49860,62028
Cook,9117,8,Strikeable,4356,4851,5420,495,1064,12244,52272,65040
Cook,9117,9,Strikeable,4555,5086,5420,531,865,12735,54660,65040
Cook,9117,10,Strikeable,4776,5086,5420,310,644,13280,57312,65040
Custodial Services Coordinator,4103,1,Strikeable,0,,,,,1500,0,
Custodial Services Coordinator,4103,2,Strikeable,0,,,,,1500,0,
Custodial Services Coordinator,4103,3,Strikeable,3005,3427,3784,422,779,8912,36060,45408
Custodial Services Coordinator,4103,4,Strikeable,3095,3427,3784,332,689,9134,37140,45408
Custodial Services Coordinator,4103,5,Strikeable,3218,3552,3952,334,734,9437,38616,47424
Custodial Services Coordinator,4103,6,Strikeable,3335,3709,4118,374,783,9726,40020,49416
Custodial Services Coordinator,4103,7,Strikeable,3483,3865,4301,382,818,10091,41796,51612
Custodial Services Coordinator,4103,8,Strikeable,3629,4036,4498,407,869,10451,43548,53976
Custodial Services Coordinator,4103,9,Strikeable,3790,4222,4498,432,708,10848,45480,53976
Custodial Services Coordinator,4103,10,Strikeable,3964,4222,4498,258,534,11277,47568,53976
Custodian,4101,1,Strikeable,0,,,,,1500,0,
Custodian,4101,2,Strikeable,0,,,,,1500,0,
Custodian,4101,3,Strikeable,0,,,,,1500,0,
Custodian,4101,4,Strikeable,0,,,,,1500,0,
Custodian,4101,5,Strikeable,0,,,,,1500,0,
Custodian,4101,6,Strikeable,3005,3427,3784,422,779,8912,36060,45408
Custodian,4101,7,Strikeable,3095,3427,3784,332,689,9134,37140,45408
Custodian,4101,8,Strikeable,3218,3552,3952,334,734,9437,38616,47424
Custodian,4101,9,Strikeable,3335,3709,3952,374,617,9726,40020,47424
Custodian,4101,10,Strikeable,3483,3709,3952,226,469,10091,41796,47424
Data Entry Control Technician,1475,1,Strikeable,0,,,,,1500,0,
Data Entry Control Technician,1475,2,Strikeable,0,,,,,1500,0,
Data Entry Control Technician,1475,3,Strikeable,0,,,,,1500,0,
Data Entry Control Technician,1475,4,Strikeable,3005,3427,3784,422,779,8912,36060,45408
Data Entry Control Technician,1475,5,Strikeable,3095,3427,3784,332,689,9134,37140,45408
Data Entry Control Technician,1475,6,Strikeable,3218,3552,3952,334,734,9437,38616,47424
Data Entry Control Technician,1475,7,Strikeable,3335,3709,4118,374,783,9726,40020,49416
Data Entry Control Technician,1475,8,Strikeable,3483,3865,4301,382,818,10091,41796,51612
Data Entry Control Technician,1475,9,Strikeable,3629,4036,4301,407,672,10451,43548,51612
Data Entry Control Technician,1475,10,Strikeable,3790,4036,4301,246,511,10848,45480,51612
Data Entry Operator,501,1,Strikeable,0,,,,,1500,0,
Data Entry Operator,501,2,Strikeable,0,,,,,1500,0,
Data Entry Operator,501,3,Strikeable,0,,,,,1500,0,
Data Entry Operator,501,4,Strikeable,3005,3427,3784,422,779,8912,36060,45408
Data Entry Operator,501,5,Strikeable,3095,3427,3784,332,689,9134,37140,45408
Data Entry Operator,501,6,Strikeable,3218,3552,3952,334,734,9437,38616,47424
Data Entry Operator,501,7,Strikeable,3335,3709,4118,374,783,9726,40020,49416
Data Entry Operator,501,8,Strikeable,3483,3865,4301,382,818,10091,41796,51612
Data Entry Operator,501,9,Strikeable,3629,4036,4301,407,672,10451,43548,51612
Data Entry Operator,501,10,Strikeable,3790,4036,4301,246,511,10848,45480,51612
Dental Assistant 2,6394,1,Strikeable,3629,4425,4943,796,1314,10451,43548,59316
Dental Assistant 2,6394,2,Strikeable,3790,4425,4943,635,1153,10848,45480,59316
Dental Assistant 2,6394,3,Strikeable,3964,4425,4943,461,979,11277,47568,59316
Dental Assistant 2,6394,4,Strikeable,4155,4639,5169,484,1014,11748,49860,62028
Dental Assistant 2,6394,5,Strikeable,4356,4851,5420,495,1064,12244,52272,65040
Dental Assistant 2,6394,6,Strikeable,4555,5086,5695,531,1140,12735,54660,68340
Dental Assistant 2,6394,7,Strikeable,4776,5345,5964,569,1188,13280,57312,71568
Dental Assistant 2,6394,8,Strikeable,5019,5598,6245,579,1226,13879,60228,74940
Dental Assistant 2,6394,9,Strikeable,5256,5861,6245,605,989,14464,63072,74940
Dental Assistant 2,6394,10,Strikeable,5503,5861,6245,358,742,15073,66036,74940
Dental Hygienist,6396,1,Strikeable,5503,6146,6866,643,1363,15073,66036,82392
Dental Hygienist,6396,2,Strikeable,5771,6444,7206,673,1435,15734,69252,86472
Dental Hygienist,6396,3,Strikeable,6051,6763,7562,712,1511,16424,72612,90744
Dental Hygienist,6396,4,Strikeable,6350,7097,7923,747,1573,17162,76200,95076
Dental Hygienist,6396,5,Strikeable,6664,7436,8314,772,1650,17936,79968,99768
Dental Hygienist,6396,6,Strikeable,6982,7803,8713,821,1731,18721,83784,104556
Dental Hygienist,6396,7,Strikeable,7327,8177,9143,850,1816,19571,87924,109716
Dental Hygienist,6396,8,Strikeable,7678,8581,9589,903,1911,20437,92136,115068
Dental Hygienist,6396,9,Strikeable,8057,8999,9589,942,1532,21372,96684,115068
Dental Hygienist,6396,10,Strikeable,8450,8999,9589,549,1139,22341,101400,115068
Dietitian 2,6371,1,Strikeable,4776,5345,5964,569,1188,13280,57312,71568
Dietitian 2,6371,2,Strikeable,5019,5598,6245,579,1226,13879,60228,74940
Dietitian 2,6371,3,Strikeable,5256,5861,6549,605,1293,14464,63072,78588
Dietitian 2,6371,4,Strikeable,5503,6146,6866,643,1363,15073,66036,82392
Dietitian 2,6371,5,Strikeable,5771,6444,7206,673,1435,15734,69252,86472
Dietitian 2,6371,6,Strikeable,6051,6763,7562,712,1511,16424,72612,90744
Dietitian 2,6371,7,Strikeable,6350,7097,7923,747,1573,17162,76200,95076
Dietitian 2,6371,8,Strikeable,6664,7436,8314,772,1650,17936,79968,99768
Dietitian 2,6371,9,Strikeable,6982,7803,8314,821,1332,18721,83784,99768
Dietitian 2,6371,10,Strikeable,7327,7803,8314,476,987,19571,87924,99768
Disability Analyst 1,5936,1,Strikeable,4155,4639,5169,484,1014,11748,49860,62028
Disability Analyst 1,5936,2,Strikeable,4356,4851,5420,495,1064,12244,52272,65040
Disability Analyst 1,5936,3,Strikeable,4555,5086,5695,531,1140,12735,54660,68340
Disability Analyst 1,5936,4,Strikeable,4776,5345,5964,569,1188,13280,57312,71568
Disability Analyst 1,5936,5,Strikeable,5019,5598,6245,579,1226,13879,60228,74940
Disability Analyst 1,5936,6,Strikeable,5256,5861,6549,605,1293,14464,63072,78588
Disability Analyst 1,5936,7,Strikeable,5503,6146,6866,643,1363,15073,66036,82392
Disability Analyst 1,5936,8,Strikeable,5771,6444,7206,673,1435,15734,69252,86472
Disability Analyst 1,5936,9,Strikeable,6051,6763,7206,712,1155,16424,72612,86472
Disability Analyst 1,5936,10,Strikeable,6350,6763,7206,413,856,17162,76200,86472
Disability Analyst 2,5937,1,Strikeable,4555,5086,5695,531,1140,12735,54660,68340
Disability Analyst 2,5937,2,Strikeable,4776,5345,5964,569,1188,13280,57312,71568
Disability Analyst 2,5937,3,Strikeable,5019,5598,6245,579,1226,13879,60228,74940
Disability Analyst 2,5937,4,Strikeable,5256,5861,6549,605,1293,14464,63072,78588
Disability Analyst 2,5937,5,Strikeable,5503,6146,6866,643,1363,15073,66036,82392
Disability Analyst 2,5937,6,Strikeable,5771,6444,7206,673,1435,15734,69252,86472
Disability Analyst 2,5937,7,Strikeable,6051,6763,7562,712,1511,16424,72612,90744
Disability Analyst 2,5937,8,Strikeable,6350,7097,7923,747,1573,17162,76200,95076
Disability Analyst 2,5937,9,Strikeable,6664,7436,7923,772,1259,17936,79968,95076
Disability Analyst 2,5937,10,Strikeable,6982,7436,7923,454,941,18721,83784,95076
District Veterinarian,6440,1,Strikeable,5503,6146,6866,643,1363,15073,66036,82392
District Veterinarian,6440,2,Strikeable,5771,6444,7206,673,1435,15734,69252,86472
District Veterinarian,6440,3,Strikeable,6051,6763,7562,712,1511,16424,72612,90744
District Veterinarian,6440,4,Strikeable,6350,7097,7923,747,1573,17162,76200,95076
District Veterinarian,6440,5,Strikeable,6664,7436,8314,772,1650,17936,79968,99768
District Veterinarian,6440,6,Strikeable,6982,7803,8713,821,1731,18721,83784,104556
District Veterinarian,6440,7,Strikeable,7327,8177,9143,850,1816,19571,87924,109716
District Veterinarian,6440,8,Strikeable,7678,8581,9589,903,1911,20437,92136,115068
District Veterinarian,6440,9,Strikeable,8057,8999,9589,942,1532,21372,96684,115068
District Veterinarian,6440,10,Strikeable,8450,8999,9589,549,1139,22341,101400,115068
DOJ Claims Examiner,5933,1,Strikeable,3964,4425,4943,461,979,11277,47568,59316
DOJ Claims Examiner,5933,2,Strikeable,4155,4639,5169,484,1014,11748,49860,62028
DOJ Claims Examiner,5933,3,Strikeable,4356,4851,5420,495,1064,12244,52272,65040
DOJ Claims Examiner,5933,4,Strikeable,4555,5086,5695,531,1140,12735,54660,68340
DOJ Claims Examiner,5933,5,Strikeable,4776,5345,5964,569,1188,13280,57312,71568
DOJ Claims Examiner,5933,6,Strikeable,5019,5598,6245,579,1226,13879,60228,74940
DOJ Claims Examiner,5933,7,Strikeable,5256,5861,6549,605,1293,14464,63072,78588
DOJ Claims Examiner,5933,8,Strikeable,5503,6146,6866,643,1363,15073,66036,82392
DOJ Claims Examiner,5933,9,Strikeable,5771,6444,6866,673,1095,15734,69252,82392
DOJ Claims Examiner,5933,10,Strikeable,6051,6444,6866,393,815,16424,72612,82392
Dormitory Counselor 1,6767,1,Strikeable,3095,3552,3952,457,857,9134,37140,47424
Dormitory Counselor 1,6767,2,Strikeable,3218,3552,3952,334,734,9437,38616,47424
Dormitory Counselor 1,6767,3,Strikeable,3335,3709,4118,374,783,9726,40020,49416
Dormitory Counselor 1,6767,4,Strikeable,3483,3865,4301,382,818,10091,41796,51612
Dormitory Counselor 1,6767,5,Strikeable,3629,4036,4498,407,869,10451,43548,53976
Dormitory Counselor 1,6767,6,Strikeable,3790,4222,4715,432,925,10848,45480,56580
Dormitory Counselor 1,6767,7,Strikeable,3964,4425,4943,461,979,11277,47568,59316
Dormitory Counselor 1,6767,8,Strikeable,4155,4639,5169,484,1014,11748,49860,62028
Dormitory Counselor 1,6767,9,Strikeable,4356,4851,5169,495,813,12244,52272,62028
Dormitory Counselor 1,6767,10,Strikeable,4555,4851,5169,296,614,12735,54660,62028
Dormitory Counselor 2,6768,1,Strikeable,3629,4222,4715,593,1086,10451,43548,56580
Dormitory Counselor 2,6768,2,Strikeable,3790,4222,4715,432,925,10848,45480,56580
Dormitory Counselor 2,6768,3,Strikeable,3964,4425,4943,461,979,11277,47568,59316
Dormitory Counselor 2,6768,4,Strikeable,4155,4639,5169,484,1014,11748,49860,62028
Dormitory Counselor 2,6768,5,Strikeable,4356,4851,5420,495,1064,12244,52272,65040
Dormitory Counselor 2,6768,6,Strikeable,4555,5086,5695,531,1140,12735,54660,68340
Dormitory Counselor 2,6768,7,Strikeable,4776,5345,5964,569,1188,13280,57312,71568
Dormitory Counselor 2,6768,8,Strikeable,5019,5598,6245,579,1226,13879,60228,74940
Dormitory Counselor 2,6768,9,Strikeable,5256,5861,6245,605,989,14464,63072,74940
Dormitory Counselor 2,6768,10,Strikeable,5503,5861,6245,358,742,15073,66036,74940
Economist 1,1161,1,Strikeable,4155,4639,5169,484,1014,11748,49860,62028
Economist 1,1161,2,Strikeable,4356,4851,5420,495,1064,12244,52272,65040
Economist 1,1161,3,Strikeable,4555,5086,5695,531,1140,12735,54660,68340
Economist 1,1161,4,Strikeable,4776,5345,5964,569,1188,13280,57312,71568
Economist 1,1161,5,Strikeable,5019,5598,6245,579,1226,13879,60228,74940
Economist 1,1161,6,Strikeable,5256,5861,6549,605,1293,14464,63072,78588
Economist 1,1161,7,Strikeable,5503,6146,6866,643,1363,15073,66036,82392
Economist 1,1161,8,Strikeable,5771,6444,7206,673,1435,15734,69252,86472
Economist 1,1161,9,Strikeable,6051,6763,7206,712,1155,16424,72612,86472
Economist 1,1161,10,Strikeable,6350,6763,7206,413,856,17162,76200,86472
Economist 2,1163,1,Strikeable,5019,5598,6245,579,1226,13879,60228,74940
Economist 2,1163,2,Strikeable,5256,5861,6549,605,1293,14464,63072,78588
Economist 2,1163,3,Strikeable,5503,6146,6866,643,1363,15073,66036,82392
Economist 2,1163,4,Strikeable,5771,6444,7206,673,1435,15734,69252,86472
Economist 2,1163,5,Strikeable,6051,6763,7562,712,1511,16424,72612,90744
Economist 2,1163,6,Strikeable,6350,7097,7923,747,1573,17162,76200,95076
Economist 2,1163,7,Strikeable,6664,7436,8314,772,1650,17936,79968,99768
Economist 2,1163,8,Strikeable,6982,7803,8713,821,1731,18721,83784,104556
Economist 2,1163,9,Strikeable,7327,8177,8713,850,1386,19571,87924,104556
Economist 2,1163,10,Strikeable,7678,8177,8713,499,1035,20437,92136,104556
Economist 3,1163,1,Strikeable,5771,6444,7206,673,1435,15734,69252,86472
Economist 3,1163,2,Strikeable,6051,6763,7562,712,1511,16424,72612,90744
Economist 3,1163,3,Strikeable,6350,7097,7923,747,1573,17162,76200,95076
Economist 3,1163,4,Strikeable,6664,7436,8314,772,1650,17936,79968,99768
Economist 3,1163,5,Strikeable,6982,7803,8713,821,1731,18721,83784,104556
Economist 3,1163,6,Strikeable,7327,8177,9143,850,1816,19571,87924,109716
Economist 3,1163,7,Strikeable,7678,8581,9589,903,1911,20437,92136,115068
Economist 3,1163,8,Strikeable,8057,8999,10065,942,2008,21372,96684,120780
Economist 3,1163,9,Strikeable,8450,9447,10065,997,1615,22341,101400,120780
Economist 3,1163,10,Strikeable,8870,9447,10065,577,1195,23377,106440,120780
Economist 4,1164,1,Strikeable,6664,7436,8314,772,1650,17936,79968,99768
Economist 4,1164,2,Strikeable,6982,7803,8713,821,1731,18721,83784,104556
Economist 4,1164,3,Strikeable,7327,8177,9143,850,1816,19571,87924,109716
Economist 4,1164,4,Strikeable,7678,8581,9589,903,1911,20437,92136,115068
Economist 4,1164,5,Strikeable,8057,8999,10065,942,2008,21372,96684,120780
Economist 4,1164,6,Strikeable,8450,9447,10545,997,2095,22341,101400,126540
Economist 4,1164,7,Strikeable,8870,9897,11065,1027,2195,23377,106440,132780
Economist 4,1164,8,Strikeable,9293,10385,11622,1092,2329,24420,111516,139464
Economist 4,1164,9,Strikeable,9751,10908,11622,1157,1871,25550,117012,139464
Economist 4,1164,10,Strikeable,10242,10908,11622,666,1380,26761,122904,139464
Education Program Specialist 1,3300,1,Strikeable,5771,6444,7206,673,1435,15734,69252,86472
Education Program Specialist 1,3300,2,Strikeable,6051,6763,7562,712,1511,16424,72612,90744
Education Program Specialist 1,3300,3,Strikeable,6350,7097,7923,747,1573,17162,76200,95076
Education Program Specialist 1,3300,4,Strikeable,6664,7436,8314,772,1650,17936,79968,99768
Education Program Specialist 1,3300,5,Strikeable,6982,7803,8713,821,1731,18721,83784,104556
Education Program Specialist 1,3300,6,Strikeable,7327,8177,9143,850,1816,19571,87924,109716
Education Program Specialist 1,3300,7,Strikeable,7678,8581,9589,903,1911,20437,92136,115068
Education Program Specialist 1,3300,8,Strikeable,8057,8999,10065,942,2008,21372,96684,120780
Education Program Specialist 1,3300,9,Strikeable,8450,9447,10065,997,1615,22341,101400,120780
Education Program Specialist 1,3300,10,Strikeable,8870,9447,10065,577,1195,23377,106440,120780
Education Program Specialist 2,3301,1,Strikeable,6664,7436,8314,772,1650,17936,79968,99768
Education Program Specialist 2,3301,2,Strikeable,6982,7803,8713,821,1731,18721,83784,104556
Education Program Specialist 2,3301,3,Strikeable,7327,8177,9143,850,1816,19571,87924,109716
Education Program Specialist 2,3301,4,Strikeable,7678,8581,9589,903,1911,20437,92136,115068
Education Program Specialist 2,3301,5,Strikeable,8057,8999,10065,942,2008,21372,96684,120780
Education Program Specialist 2,3301,6,Strikeable,8450,9447,10545,997,2095,22341,101400,126540
Education Program Specialist 2,3301,7,Strikeable,8870,9897,11065,1027,2195,23377,106440,132780
Education Program Specialist 2,3301,8,Strikeable,9293,10385,11622,1092,2329,24420,111516,139464
Education Program Specialist 2,3301,9,Strikeable,9751,10908,11622,1157,1871,25550,117012,139464
Education Program Specialist 2,3301,10,Strikeable,10242,10908,11622,666,1380,26761,122904,139464
Electrician 2,4008,1,Strikeable,4776,5345,5964,569,1188,13280,57312,71568
Electrician 2,4008,2,Strikeable,5019,5598,6245,579,1226,13879,60228,74940
Electrician 2,4008,3,Strikeable,5256,5861,6549,605,1293,14464,63072,78588
Electrician 2,4008,4,Strikeable,5503,6146,6866,643,1363,15073,66036,82392
Electrician 2,4008,5,Strikeable,5771,6444,7206,673,1435,15734,69252,86472
Electrician 2,4008,6,Strikeable,6051,6763,7562,712,1511,16424,72612,90744
Electrician 2,4008,7,Strikeable,6350,7097,7923,747,1573,17162,76200,95076
Electrician 2,4008,8,Strikeable,6664,7436,8314,772,1650,17936,79968,99768
Electrician 2,4008,9,Strikeable,6982,7803,8314,821,1332,18721,83784,99768
Electrician 2,4008,10,Strikeable,7327,7803,8314,476,987,19571,87924,99768
Electrician 3,4009,1,Strikeable,5256,5861,6549,605,1293,14464,63072,78588
Electrician 3,4009,2,Strikeable,5503,6146,6866,643,1363,15073,66036,82392
Electrician 3,4009,3,Strikeable,5771,6444,7206,673,1435,15734,69252,86472
Electrician 3,4009,4,Strikeable,6051,6763,7562,712,1511,16424,72612,90744
Electrician 3,4009,5,Strikeable,6350,7097,7923,747,1573,17162,76200,95076
Electrician 3,4009,6,Strikeable,6664,7436,8314,772,1650,17936,79968,99768
Electrician 3,4009,7,Strikeable,6982,7803,8713,821,1731,18721,83784,104556
Electrician 3,4009,8,Strikeable,7327,8177,9143,850,1816,19571,87924,109716
Electrician 3,4009,9,Strikeable,7678,8581,9143,903,1465,20437,92136,109716
Electrician 3,4009,10,Strikeable,8057,8581,9143,524,1086,21372,96684,109716
Electronic Publishing Design Specialist 1,3510,1,Strikeable,3218,3709,4118,491,900,9437,38616,49416
Electronic Publishing Design Specialist 1,3510,2,Strikeable,3335,3709,4118,374,783,9726,40020,49416
Electronic Publishing Design Specialist 1,3510,3,Strikeable,3483,3865,4301,382,818,10091,41796,51612
Electronic Publishing Design Specialist 1,3510,4,Strikeable,3629,4036,4498,407,869,10451,43548,53976
Electronic Publishing Design Specialist 1,3510,5,Strikeable,3790,4222,4715,432,925,10848,45480,56580
Electronic Publishing Design Specialist 1,3510,6,Strikeable,3964,4425,4943,461,979,11277,47568,59316
Electronic Publishing Design Specialist 1,3510,7,Strikeable,4155,4639,5169,484,1014,11748,49860,62028
Electronic Publishing Design Specialist 1,3510,8,Strikeable,4356,4851,5420,495,1064,12244,52272,65040
Electronic Publishing Design Specialist 1,3510,9,Strikeable,4555,5086,5420,531,865,12735,54660,65040
Electronic Publishing Design Specialist 1,3510,10,Strikeable,4776,5086,5420,310,644,13280,57312,65040
Electronic Publishing Design Specialist 2,3511,1,Strikeable,3964,4425,4943,461,979,11277,47568,59316
Electronic Publishing Design Specialist 2,3511,2,Strikeable,4155,4639,5169,484,1014,11748,49860,62028
Electronic Publishing Design Specialist 2,3511,3,Strikeable,4356,4851,5420,495,1064,12244,52272,65040
Electronic Publishing Design Specialist 2,3511,4,Strikeable,4555,5086,5695,531,1140,12735,54660,68340
Electronic Publishing Design Specialist 2,3511,5,Strikeable,4776,5345,5964,569,1188,13280,57312,71568
Electronic Publishing Design Specialist 2,3511,6,Strikeable,5019,5598,6245,579,1226,13879,60228,74940
Electronic Publishing Design Specialist 2,3511,7,Strikeable,5256,5861,6549,605,1293,14464,63072,78588
Electronic Publishing Design Specialist 2,3511,8,Strikeable,5503,6146,6866,643,1363,15073,66036,82392
Electronic Publishing Design Specialist 2,3511,9,Strikeable,5771,6444,6866,673,1095,15734,69252,82392
Electronic Publishing Design Specialist 2,3511,10,Strikeable,6051,6444,6866,393,815,16424,72612,82392
Electronic Publishing Design Specialist 3,3513,1,Strikeable,4356,4851,5420,495,1064,12244,52272,65040
Electronic Publishing Design Specialist 3,3513,2,Strikeable,4555,5086,5695,531,1140,12735,54660,68340
Electronic Publishing Design Specialist 3,3513,3,Strikeable,4776,5345,5964,569,1188,13280,57312,71568
Electronic Publishing Design Specialist 3,3513,4,Strikeable,5019,5598,6245,579,1226,13879,60228,74940
Electronic Publishing Design Specialist 3,3513,5,Strikeable,5256,5861,6549,605,1293,14464,63072,78588
Electronic Publishing Design Specialist 3,3513,6,Strikeable,5503,6146,6866,643,1363,15073,66036,82392
Electronic Publishing Design Specialist 3,3513,7,Strikeable,5771,6444,7206,673,1435,15734,69252,86472
Electronic Publishing Design Specialist 3,3513,8,Strikeable,6051,6763,7562,712,1511,16424,72612,90744
Electronic Publishing Design Specialist 3,3513,9,Strikeable,6350,7097,7562,747,1212,17162,76200,90744
Electronic Publishing Design Specialist 3,3513,10,Strikeable,6664,7097,7562,433,898,17936,79968,90744
Electronic Security Technician 2,4051,1,Strikeable,4776,5345,5964,569,1188,13280,57312,71568
Electronic Security Technician 2,4051,2,Strikeable,5019,5598,6245,579,1226,13879,60228,74940
Electronic Security Technician 2,4051,3,Strikeable,5256,5861,6549,605,1293,14464,63072,78588
Electronic Security Technician 2,4051,4,Strikeable,5503,6146,6866,643,1363,15073,66036,82392
Electronic Security Technician 2,4051,5,Strikeable,5771,6444,7206,673,1435,15734,69252,86472
Electronic Security Technician 2,4051,6,Strikeable,6051,6763,7562,712,1511,16424,72612,90744
Electronic Security Technician 2,4051,7,Strikeable,6350,7097,7923,747,1573,17162,76200,95076
Electronic Security Technician 2,4051,8,Strikeable,6664,7436,8314,772,1650,17936,79968,99768
Electronic Security Technician 2,4051,9,Strikeable,6982,7803,8314,821,1332,18721,83784,99768
Electronic Security Technician 2,4051,10,Strikeable,7327,7803,8314,476,987,19571,87924,99768
Employment Adjudicator,6693,1,Strikeable,4155,4639,5169,484,1014,11748,49860,62028
Employment Adjudicator,6693,2,Strikeable,4356,4851,5420,495,1064,12244,52272,65040
Employment Adjudicator,6693,3,Strikeable,4555,5086,5695,531,1140,12735,54660,68340
Employment Adjudicator,6693,4,Strikeable,4776,5345,5964,569,1188,13280,57312,71568
Employment Adjudicator,6693,5,Strikeable,5019,5598,6245,579,1226,13879,60228,74940
Employment Adjudicator,6693,6,Strikeable,5256,5861,6549,605,1293,14464,63072,78588
Employment Adjudicator,6693,7,Strikeable,5503,6146,6866,643,1363,15073,66036,82392
Employment Adjudicator,6693,8,Strikeable,5771,6444,7206,673,1435,15734,69252,86472
Employment Adjudicator,6693,9,Strikeable,6051,6763,7206,712,1155,16424,72612,86472
Employment Adjudicator,6693,10,Strikeable,6350,6763,7206,413,856,17162,76200,86472
Employment Appeals Board Legal Staff,1543,1,Strikeable,5503,6146,6866,643,1363,15073,66036,82392
Employment Appeals Board Legal Staff,1543,2,Strikeable,5771,6444,7206,673,1435,15734,69252,86472
Employment Appeals Board Legal Staff,1543,3,Strikeable,6051,6763,7562,712,1511,16424,72612,90744
Employment Appeals Board Legal Staff,1543,4,Strikeable,6350,7097,7923,747,1573,17162,76200,95076
Employment Appeals Board Legal Staff,1543,5,Strikeable,6664,7436,8314,772,1650,17936,79968,99768
Employment Appeals Board Legal Staff,1543,6,Strikeable,6982,7803,8713,821,1731,18721,83784,104556
Employment Appeals Board Legal Staff,1543,7,Strikeable,7327,8177,9143,850,1816,19571,87924,109716
Employment Appeals Board Legal Staff,1543,8,Strikeable,7678,8581,9589,903,1911,20437,92136,115068
Employment Appeals Board Legal Staff,1543,9,Strikeable,8057,8999,9589,942,1532,21372,96684,115068
Employment Appeals Board Legal Staff,1543,10,Strikeable,8450,8999,9589,549,1139,22341,101400,115068
Engineering Technician 2,3110,1,Strikeable,3483,4036,4498,553,1015,10091,41796,53976
Engineering Technician 2,3110,2,Strikeable,3629,4036,4498,407,869,10451,43548,53976
Engineering Technician 2,3110,3,Strikeable,3790,4222,4715,432,925,10848,45480,56580
Engineering Technician 2,3110,4,Strikeable,3964,4425,4943,461,979,11277,47568,59316
Engineering Technician 2,3110,5,Strikeable,4155,4639,5169,484,1014,11748,49860,62028
Engineering Technician 2,3110,6,Strikeable,4356,4851,5420,495,1064,12244,52272,65040
Engineering Technician 2,3110,7,Strikeable,4555,5086,5695,531,1140,12735,54660,68340
Engineering Technician 2,3110,8,Strikeable,4776,5345,5964,569,1188,13280,57312,71568
Engineering Technician 2,3110,9,Strikeable,5019,5598,5964,579,945,13879,60228,71568
Engineering Technician 2,3110,10,Strikeable,5256,5598,5964,342,708,14464,63072,71568
Engineering Technician 3,3111,1,Strikeable,3790,4425,4943,635,1153,10848,45480,59316
Engineering Technician 3,3111,2,Strikeable,3964,4425,4943,461,979,11277,47568,59316
Engineering Technician 3,3111,3,Strikeable,4155,4639,5169,484,1014,11748,49860,62028
Engineering Technician 3,3111,4,Strikeable,4356,4851,5420,495,1064,12244,52272,65040
Engineering Technician 3,3111,5,Strikeable,4555,5086,5695,531,1140,12735,54660,68340
Engineering Technician 3,3111,6,Strikeable,4776,5345,5964,569,1188,13280,57312,71568
Engineering Technician 3,3111,7,Strikeable,5019,5598,6245,579,1226,13879,60228,74940
Engineering Technician 3,3111,8,Strikeable,5256,5861,6549,605,1293,14464,63072,78588
Engineering Technician 3,3111,9,Strikeable,5503,6146,6549,643,1046,15073,66036,78588
Engineering Technician 3,3111,10,Strikeable,5771,6146,6549,375,778,15734,69252,78588
Environmental Engineer 2,3411,1,Strikeable,5771,6444,7206,673,1435,15734,69252,86472
Environmental Engineer 2,3411,2,Strikeable,6051,6763,7562,712,1511,16424,72612,90744
Environmental Engineer 2,3411,3,Strikeable,6350,7097,7923,747,1573,17162,76200,95076
Environmental Engineer 2,3411,4,Strikeable,6664,7436,8314,772,1650,17936,79968,99768
Environmental Engineer 2,3411,5,Strikeable,6982,7803,8713,821,1731,18721,83784,104556
Environmental Engineer 2,3411,6,Strikeable,7327,8177,9143,850,1816,19571,87924,109716
Environmental Engineer 2,3411,7,Strikeable,7678,8581,9589,903,1911,20437,92136,115068
Environmental Engineer 2,3411,8,Strikeable,8057,8999,10065,942,2008,21372,96684,120780
Environmental Engineer 2,3411,9,Strikeable,8450,9447,10065,997,1615,22341,101400,120780
Environmental Engineer 2,3411,10,Strikeable,8870,9447,10065,577,1195,23377,106440,120780
Environmental Engineer 3,3413,1,Strikeable,6664,7436,8314,772,1650,17936,79968,99768
Environmental Engineer 3,3413,2,Strikeable,6982,7803,8713,821,1731,18721,83784,104556
Environmental Engineer 3,3413,3,Strikeable,7327,8177,9143,850,1816,19571,87924,109716
Environmental Engineer 3,3413,4,Strikeable,7678,8581,9589,903,1911,20437,92136,115068
Environmental Engineer 3,3413,5,Strikeable,8057,8999,10065,942,2008,21372,96684,120780
Environmental Engineer 3,3413,6,Strikeable,8450,9447,10545,997,2095,22341,101400,126540
Environmental Engineer 3,3413,7,Strikeable,8870,9897,11065,1027,2195,23377,106440,132780
Environmental Engineer 3,3413,8,Strikeable,9293,10385,11622,1092,2329,24420,111516,139464
Environmental Engineer 3,3413,9,Strikeable,9751,10908,11622,1157,1871,25550,117012,139464
Environmental Engineer 3,3413,10,Strikeable,10242,10908,11622,666,1380,26761,122904,139464
Environmental Health Specialist 3,3819,1,Strikeable,5256,5861,6549,605,1293,14464,63072,78588
Environmental Health Specialist 3,3819,2,Strikeable,5503,6146,6866,643,1363,15073,66036,82392
Environmental Health Specialist 3,3819,3,Strikeable,5771,6444,7206,673,1435,15734,69252,86472
Environmental Health Specialist 3,3819,4,Strikeable,6051,6763,7562,712,1511,16424,72612,90744
Environmental Health Specialist 3,3819,5,Strikeable,6350,7097,7923,747,1573,17162,76200,95076
Environmental Health Specialist 3,3819,6,Strikeable,6664,7436,8314,772,1650,17936,79968,99768
Environmental Health Specialist 3,3819,7,Strikeable,6982,7803,8713,821,1731,18721,83784,104556
Environmental Health Specialist 3,3819,8,Strikeable,7327,8177,9143,850,1816,19571,87924,109716
Environmental Health Specialist 3,3819,9,Strikeable,7678,8581,9143,903,1465,20437,92136,109716
Environmental Health Specialist 3,3819,10,Strikeable,8057,8581,9143,524,1086,21372,96684,109716
Epidemiologist 1,6316,1,Strikeable,5019,5598,6245,579,1226,13879,60228,74940
Epidemiologist 1,6316,2,Strikeable,5256,5861,6549,605,1293,14464,63072,78588
Epidemiologist 1,6316,3,Strikeable,5503,6146,6866,643,1363,15073,66036,82392
Epidemiologist 1,6316,4,Strikeable,5771,6444,7206,673,1435,15734,69252,86472
Epidemiologist 1,6316,5,Strikeable,6051,6763,7562,712,1511,16424,72612,90744
Epidemiologist 1,6316,6,Strikeable,6350,7097,7923,747,1573,17162,76200,95076
Epidemiologist 1,6316,7,Strikeable,6664,7436,8314,772,1650,17936,79968,99768
Epidemiologist 1,6316,8,Strikeable,6982,7803,8713,821,1731,18721,83784,104556
Epidemiologist 1,6316,9,Strikeable,7327,8177,8713,850,1386,19571,87924,104556
Epidemiologist 1,6316,10,Strikeable,7678,8177,8713,499,1035,20437,92136,104556
Epidemiologist 2,6317,1,Strikeable,5771,6444,7206,673,1435,15734,69252,86472
Epidemiologist 2,6317,2,Strikeable,6051,6763,7562,712,1511,16424,72612,90744
Epidemiologist 2,6317,3,Strikeable,6350,7097,7923,747,1573,17162,76200,95076
Epidemiologist 2,6317,4,Strikeable,6664,7436,8314,772,1650,17936,79968,99768
Epidemiologist 2,6317,5,Strikeable,6982,7803,8713,821,1731,18721,83784,104556
Epidemiologist 2,6317,6,Strikeable,7327,8177,9143,850,1816,19571,87924,109716
Epidemiologist 2,6317,7,Strikeable,7678,8581,9589,903,1911,20437,92136,115068
Epidemiologist 2,6317,8,Strikeable,8057,8999,10065,942,2008,21372,96684,120780
Epidemiologist 2,6317,9,Strikeable,8450,9447,10065,997,1615,22341,101400,120780
Epidemiologist 2,6317,10,Strikeable,8870,9447,10065,577,1195,23377,106440,120780
Epidemiologist 3,6318,1,Strikeable,6350,7097,7923,747,1573,17162,76200,95076
Epidemiologist 3,6318,2,Strikeable,6664,7436,8314,772,1650,17936,79968,99768
Epidemiologist 3,6318,3,Strikeable,6982,7803,8713,821,1731,18721,83784,104556
Epidemiologist 3,6318,4,Strikeable,7327,8177,9143,850,1816,19571,87924,109716
Epidemiologist 3,6318,5,Strikeable,7678,8581,9589,903,1911,20437,92136,115068
Epidemiologist 3,6318,6,Strikeable,8057,8999,10065,942,2008,21372,96684,120780
Epidemiologist 3,6318,7,Strikeable,8450,9447,10545,997,2095,22341,101400,126540
Epidemiologist 3,6318,8,Strikeable,8870,9897,11065,1027,2195,23377,106440,132780
Epidemiologist 3,6318,9,Strikeable,9293,10385,11065,1092,1772,24420,111516,132780
Epidemiologist 3,6318,10,Strikeable,9751,10385,11065,634,1314,25550,117012,132780
Equipment Operator,4433,1,Strikeable,3790,4425,4943,635,1153,10848,45480,59316
Equipment Operator,4433,2,Strikeable,3964,4425,4943,461,979,11277,47568,59316
Equipment Operator,4433,3,Strikeable,4155,4639,5169,484,1014,11748,49860,62028
Equipment Operator,4433,4,Strikeable,4356,4851,5420,495,1064,12244,52272,65040
Equipment Operator,4433,5,Strikeable,4555,5086,5695,531,1140,12735,54660,68340
Equipment Operator,4433,6,Strikeable,4776,5345,5964,569,1188,13280,57312,71568
Equipment Operator,4433,7,Strikeable,5019,5598,6245,579,1226,13879,60228,74940
Equipment Operator,4433,8,Strikeable,5256,5861,6549,605,1293,14464,63072,78588
Equipment Operator,4433,9,Strikeable,5503,6146,6549,643,1046,15073,66036,78588
Equipment Operator,4433,10,Strikeable,5771,6146,6549,375,778,15734,69252,78588
Executive Assistant,830,1,Strikeable,4555,5086,5695,531,1140,12735,54660,68340
Executive Assistant,830,2,Strikeable,4776,5345,5964,569,1188,13280,57312,71568
Executive Assistant,830,3,Strikeable,5019,5598,6245,579,1226,13879,60228,74940
Executive Assistant,830,4,Strikeable,5256,5861,6549,605,1293,14464,63072,78588
Executive Assistant,830,5,Strikeable,5503,6146,6866,643,1363,15073,66036,82392
Executive Assistant,830,6,Strikeable,5771,6444,7206,673,1435,15734,69252,86472
Executive Assistant,830,7,Strikeable,6051,6763,7562,712,1511,16424,72612,90744
Executive Assistant,830,8,Strikeable,6350,7097,7923,747,1573,17162,76200,95076
Executive Assistant,830,9,Strikeable,6664,7436,7923,772,1259,17936,79968,95076
Executive Assistant,830,10,Strikeable,6982,7436,7923,454,941,18721,83784,95076
Executive Support Specialist 1,118,1,Strikeable,3218,3709,4118,491,900,9437,38616,49416
Executive Support Specialist 1,118,2,Strikeable,3335,3709,4118,374,783,9726,40020,49416
Executive Support Specialist 1,118,3,Strikeable,3483,3865,4301,382,818,10091,41796,51612
Executive Support Specialist 1,118,4,Strikeable,3629,4036,4498,407,869,10451,43548,53976
Executive Support Specialist 1,118,5,Strikeable,3790,4222,4715,432,925,10848,45480,56580
Executive Support Specialist 1,118,6,Strikeable,3964,4425,4943,461,979,11277,47568,59316
Executive Support Specialist 1,118,7,Strikeable,4155,4639,5169,484,1014,11748,49860,62028
Executive Support Specialist 1,118,8,Strikeable,4356,4851,5420,495,1064,12244,52272,65040
Executive Support Specialist 1,118,9,Strikeable,4555,5086,5420,531,865,12735,54660,65040
Executive Support Specialist 1,118,10,Strikeable,4776,5086,5420,310,644,13280,57312,65040
Executive Support Specialist 2,119,1,Strikeable,3629,4222,4715,593,1086,10451,43548,56580
Executive Support Specialist 2,119,2,Strikeable,3790,4222,4715,432,925,10848,45480,56580
Executive Support Specialist 2,119,3,Strikeable,3964,4425,4943,461,979,11277,47568,59316
Executive Support Specialist 2,119,4,Strikeable,4155,4639,5169,484,1014,11748,49860,62028
Executive Support Specialist 2,119,5,Strikeable,4356,4851,5420,495,1064,12244,52272,65040
Executive Support Specialist 2,119,6,Strikeable,4555,5086,5695,531,1140,12735,54660,68340
Executive Support Specialist 2,119,7,Strikeable,4776,5345,5964,569,1188,13280,57312,71568
Executive Support Specialist 2,119,8,Strikeable,5019,5598,6245,579,1226,13879,60228,74940
Executive Support Specialist 2,119,9,Strikeable,5256,5861,6245,605,989,14464,63072,74940
Executive Support Specialist 2,119,10,Strikeable,5503,5861,6245,358,742,15073,66036,74940
Facilities Engineer 1,3351,1,Strikeable,5019,5598,6245,579,1226,13879,60228,74940
Facilities Engineer 1,3351,2,Strikeable,5256,5861,6549,605,1293,14464,63072,78588
Facilities Engineer 1,3351,3,Strikeable,5503,6146,6866,643,1363,15073,66036,82392
Facilities Engineer 1,3351,4,Strikeable,5771,6444,7206,673,1435,15734,69252,86472
Facilities Engineer 1,3351,5,Strikeable,6051,6763,7562,712,1511,16424,72612,90744
Facilities Engineer 1,3351,6,Strikeable,6350,7097,7923,747,1573,17162,76200,95076
Facilities Engineer 1,3351,7,Strikeable,6664,7436,8314,772,1650,17936,79968,99768
Facilities Engineer 1,3351,8,Strikeable,6982,7803,8713,821,1731,18721,83784,104556
Facilities Engineer 1,3351,9,Strikeable,7327,8177,8713,850,1386,19571,87924,104556
Facilities Engineer 1,3351,10,Strikeable,7678,8177,8713,499,1035,20437,92136,104556
Facilities Engineer 3,3353,1,Strikeable,6664,7436,8314,772,1650,17936,79968,99768
Facilities Engineer 3,3353,2,Strikeable,6982,7803,8713,821,1731,18721,83784,104556
Facilities Engineer 3,3353,3,Strikeable,7327,8177,9143,850,1816,19571,87924,109716
Facilities Engineer 3,3353,4,Strikeable,7678,8581,9589,903,1911,20437,92136,115068
Facilities Engineer 3,3353,5,Strikeable,8057,8999,10065,942,2008,21372,96684,120780
Facilities Engineer 3,3353,6,Strikeable,8450,9447,10545,997,2095,22341,101400,126540
Facilities Engineer 3,3353,7,Strikeable,8870,9897,11065,1027,2195,23377,106440,132780
Facilities Engineer 3,3353,8,Strikeable,9293,10385,11622,1092,2329,24420,111516,139464
Facilities Engineer 3,3353,9,Strikeable,9751,10908,11622,1157,1871,25550,117012,139464
Facilities Engineer 3,3353,10,Strikeable,10242,10908,11622,666,1380,26761,122904,139464
Facility Energy Technician 2,4033,1,Strikeable,3964,4425,4943,461,979,11277,47568,59316
Facility Energy Technician 2,4033,2,Strikeable,4155,4639,5169,484,1014,11748,49860,62028
Facility Energy Technician 2,4033,3,Strikeable,4356,4851,5420,495,1064,12244,52272,65040
Facility Energy Technician 2,4033,4,Strikeable,4555,5086,5695,531,1140,12735,54660,68340
Facility Energy Technician 2,4033,5,Strikeable,4776,5345,5964,569,1188,13280,57312,71568
Facility Energy Technician 2,4033,6,Strikeable,5019,5598,6245,579,1226,13879,60228,74940
Facility Energy Technician 2,4033,7,Strikeable,5256,5861,6549,605,1293,14464,63072,78588
Facility Energy Technician 2,4033,8,Strikeable,5503,6146,6866,643,1363,15073,66036,82392
Facility Energy Technician 2,4033,9,Strikeable,5771,6444,6866,673,1095,15734,69252,82392
Facility Energy Technician 2,4033,10,Strikeable,6051,6444,6866,393,815,16424,72612,82392
Facility Energy Technician 3,4034,1,Strikeable,4776,5345,5964,569,1188,13280,57312,71568
Facility Energy Technician 3,4034,2,Strikeable,5019,5598,6245,579,1226,13879,60228,74940
Facility Energy Technician 3,4034,3,Strikeable,5256,5861,6549,605,1293,14464,63072,78588
Facility Energy Technician 3,4034,4,Strikeable,5503,6146,6866,643,1363,15073,66036,82392
Facility Energy Technician 3,4034,5,Strikeable,5771,6444,7206,673,1435,15734,69252,86472
Facility Energy Technician 3,4034,6,Strikeable,6051,6763,7562,712,1511,16424,72612,90744
Facility Energy Technician 3,4034,7,Strikeable,6350,7097,7923,747,1573,17162,76200,95076
Facility Energy Technician 3,4034,8,Strikeable,6664,7436,8314,772,1650,17936,79968,99768
Facility Energy Technician 3,4034,9,Strikeable,6982,7803,8314,821,1332,18721,83784,99768
Facility Energy Technician 3,4034,10,Strikeable,7327,7803,8314,476,987,19571,87924,99768
Facility Energy Technician 4,4035,1,Strikeable,5503,6146,6866,643,1363,15073,66036,82392
Facility Energy Technician 4,4035,2,Strikeable,5771,6444,7206,673,1435,15734,69252,86472
Facility Energy Technician 4,4035,3,Strikeable,6051,6763,7562,712,1511,16424,72612,90744
Facility Energy Technician 4,4035,4,Strikeable,6350,7097,7923,747,1573,17162,76200,95076
Facility Energy Technician 4,4035,5,Strikeable,6664,7436,8314,772,1650,17936,79968,99768
Facility Energy Technician 4,4035,6,Strikeable,6982,7803,8713,821,1731,18721,83784,104556
Facility Energy Technician 4,4035,7,Strikeable,7327,8177,9143,850,1816,19571,87924,109716
Facility Energy Technician 4,4035,8,Strikeable,7678,8581,9589,903,1911,20437,92136,115068
Facility Energy Technician 4,4035,9,Strikeable,8057,8999,9589,942,1532,21372,96684,115068
Facility Energy Technician 4,4035,10,Strikeable,8450,8999,9589,549,1139,22341,101400,115068
Facility Maintenance Specialist,4013,1,Strikeable,3335,3865,4301,530,966,9726,40020,51612
Facility Maintenance Specialist,4013,2,Strikeable,3483,3865,4301,382,818,10091,41796,51612
Facility Maintenance Specialist,4013,3,Strikeable,3629,4036,4498,407,869,10451,43548,53976
Facility Maintenance Specialist,4013,4,Strikeable,3790,4222,4715,432,925,10848,45480,56580
Facility Maintenance Specialist,4013,5,Strikeable,3964,4425,4943,461,979,11277,47568,59316
Facility Maintenance Specialist,4013,6,Strikeable,4155,4639,5169,484,1014,11748,49860,62028
Facility Maintenance Specialist,4013,7,Strikeable,4356,4851,5420,495,1064,12244,52272,65040
Facility Maintenance Specialist,4013,8,Strikeable,4555,5086,5695,531,1140,12735,54660,68340
Facility Maintenance Specialist,4013,9,Strikeable,4776,5345,5695,569,919,13280,57312,68340
Facility Maintenance Specialist,4013,10,Strikeable,5019,5345,5695,326,676,13879,60228,68340
Facility Operations Specialist 1,4014,1,Strikeable,4356,4851,5420,495,1064,12244,52272,65040
Facility Operations Specialist 1,4014,2,Strikeable,4555,5086,5695,531,1140,12735,54660,68340
Facility Operations Specialist 1,4014,3,Strikeable,4776,5345,5964,569,1188,13280,57312,71568
Facility Operations Specialist 1,4014,4,Strikeable,5019,5598,6245,579,1226,13879,60228,74940
Facility Operations Specialist 1,4014,5,Strikeable,5256,5861,6549,605,1293,14464,63072,78588
Facility Operations Specialist 1,4014,6,Strikeable,5503,6146,6866,643,1363,15073,66036,82392
Facility Operations Specialist 1,4014,7,Strikeable,5771,6444,7206,673,1435,15734,69252,86472
Facility Operations Specialist 1,4014,8,Strikeable,6051,6763,7562,712,1511,16424,72612,90744
Facility Operations Specialist 1,4014,9,Strikeable,6350,7097,7562,747,1212,17162,76200,90744
Facility Operations Specialist 1,4014,10,Strikeable,6664,7097,7562,433,898,17936,79968,90744
Facility Operations Specialist 2,4015,1,Strikeable,4776,5345,5964,569,1188,13280,57312,71568
Facility Operations Specialist 2,4015,2,Strikeable,5019,5598,6245,579,1226,13879,60228,74940
Facility Operations Specialist 2,4015,3,Strikeable,5256,5861,6549,605,1293,14464,63072,78588
Facility Operations Specialist 2,4015,4,Strikeable,5503,6146,6866,643,1363,15073,66036,82392
Facility Operations Specialist 2,4015,5,Strikeable,5771,6444,7206,673,1435,15734,69252,86472
Facility Operations Specialist 2,4015,6,Strikeable,6051,6763,7562,712,1511,16424,72612,90744
Facility Operations Specialist 2,4015,7,Strikeable,6350,7097,7923,747,1573,17162,76200,95076
Facility Operations Specialist 2,4015,8,Strikeable,6664,7436,8314,772,1650,17936,79968,99768
Facility Operations Specialist 2,4015,9,Strikeable,6982,7803,8314,821,1332,18721,83784,99768
Facility Operations Specialist 2,4015,10,Strikeable,7327,7803,8314,476,987,19571,87924,99768
Financial Enforcement Officer,1547,1,Strikeable,6350,7097,7923,747,1573,17162,76200,95076
Financial Enforcement Officer,1547,2,Strikeable,6664,7436,8314,772,1650,17936,79968,99768
Financial Enforcement Officer,1547,3,Strikeable,6982,7803,8713,821,1731,18721,83784,104556
Financial Enforcement Officer,1547,4,Strikeable,7327,8177,9143,850,1816,19571,87924,109716
Financial Enforcement Officer,1547,5,Strikeable,7678,8581,9589,903,1911,20437,92136,115068
Financial Enforcement Officer,1547,6,Strikeable,8057,8999,10065,942,2008,21372,96684,120780
Financial Enforcement Officer,1547,7,Strikeable,8450,9447,10545,997,2095,22341,101400,126540
Financial Enforcement Officer,1547,8,Strikeable,8870,9897,11065,1027,2195,23377,106440,132780
Financial Enforcement Officer,1547,9,Strikeable,9293,10385,11065,1092,1772,24420,111516,132780
Financial Enforcement Officer,1547,10,Strikeable,9751,10385,11065,634,1314,25550,117012,132780
Financial Examiner 1,5675,1,Strikeable,4356,4851,5420,495,1064,12244,52272,65040
Financial Examiner 1,5675,2,Strikeable,4555,5086,5695,531,1140,12735,54660,68340
Financial Examiner 1,5675,3,Strikeable,4776,5345,5964,569,1188,13280,57312,71568
Financial Examiner 1,5675,4,Strikeable,5019,5598,6245,579,1226,13879,60228,74940
Financial Examiner 1,5675,5,Strikeable,5256,5861,6549,605,1293,14464,63072,78588
Financial Examiner 1,5675,6,Strikeable,5503,6146,6866,643,1363,15073,66036,82392
Financial Examiner 1,5675,7,Strikeable,5771,6444,7206,673,1435,15734,69252,86472
Financial Examiner 1,5675,8,Strikeable,6051,6763,7562,712,1511,16424,72612,90744
Financial Examiner 1,5675,9,Strikeable,6350,7097,7562,747,1212,17162,76200,90744
Financial Examiner 1,5675,10,Strikeable,6664,7097,7562,433,898,17936,79968,90744
Financial Examiner 2,5676,1,Strikeable,5019,5598,6245,579,1226,13879,60228,74940
Financial Examiner 2,5676,2,Strikeable,5256,5861,6549,605,1293,14464,63072,78588
Financial Examiner 2,5676,3,Strikeable,5503,6146,6866,643,1363,15073,66036,82392
Financial Examiner 2,5676,4,Strikeable,5771,6444,7206,673,1435,15734,69252,86472
Financial Examiner 2,5676,5,Strikeable,6051,6763,7562,712,1511,16424,72612,90744
Financial Examiner 2,5676,6,Strikeable,6350,7097,7923,747,1573,17162,76200,95076
Financial Examiner 2,5676,7,Strikeable,6664,7436,8314,772,1650,17936,79968,99768
Financial Examiner 2,5676,8,Strikeable,6982,7803,8713,821,1731,18721,83784,104556
Financial Examiner 2,5676,9,Strikeable,7327,8177,8713,850,1386,19571,87924,104556
Financial Examiner 2,5676,10,Strikeable,7678,8177,8713,499,1035,20437,92136,104556
Financial Examiner 3,5677,1,Strikeable,5771,6444,7206,673,1435,15734,69252,86472
Financial Examiner 3,5677,2,Strikeable,6051,6763,7562,712,1511,16424,72612,90744
Financial Examiner 3,5677,3,Strikeable,6350,7097,7923,747,1573,17162,76200,95076
Financial Examiner 3,5677,4,Strikeable,6664,7436,8314,772,1650,17936,79968,99768
Financial Examiner 3,5677,5,Strikeable,6982,7803,8713,821,1731,18721,83784,104556
Financial Examiner 3,5677,6,Strikeable,7327,8177,9143,850,1816,19571,87924,109716
Financial Examiner 3,5677,7,Strikeable,7678,8581,9589,903,1911,20437,92136,115068
Financial Examiner 3,5677,8,Strikeable,8057,8999,10065,942,2008,21372,96684,120780
Financial Examiner 3,5677,9,Strikeable,8450,9447,10065,997,1615,22341,101400,120780
Financial Examiner 3,5677,10,Strikeable,8870,9447,10065,577,1195,23377,106440,120780
Financial Investigator 1,5335,1,Strikeable,4776,5345,5964,569,1188,13280,57312,71568
Financial Investigator 1,5335,2,Strikeable,5019,5598,6245,579,1226,13879,60228,74940
Financial Investigator 1,5335,3,Strikeable,5256,5861,6549,605,1293,14464,63072,78588
Financial Investigator 1,5335,4,Strikeable,5503,6146,6866,643,1363,15073,66036,82392
Financial Investigator 1,5335,5,Strikeable,5771,6444,7206,673,1435,15734,69252,86472
Financial Investigator 1,5335,6,Strikeable,6051,6763,7562,712,1511,16424,72612,90744
Financial Investigator 1,5335,7,Strikeable,6350,7097,7923,747,1573,17162,76200,95076
Financial Investigator 1,5335,8,Strikeable,6664,7436,8314,772,1650,17936,79968,99768
Financial Investigator 1,5335,9,Strikeable,6982,7803,8314,821,1332,18721,83784,99768
Financial Investigator 1,5335,10,Strikeable,7327,7803,8314,476,987,19571,87924,99768
Fiscal Analyst 1,1343,1,Strikeable,4155,4639,5169,484,1014,11748,49860,62028
Fiscal Analyst 1,1343,2,Strikeable,4356,4851,5420,495,1064,12244,52272,65040
Fiscal Analyst 1,1343,3,Strikeable,4555,5086,5695,531,1140,12735,54660,68340
Fiscal Analyst 1,1343,4,Strikeable,4776,5345,5964,569,1188,13280,57312,71568
Fiscal Analyst 1,1343,5,Strikeable,5019,5598,6245,579,1226,13879,60228,74940
Fiscal Analyst 1,1343,6,Strikeable,5256,5861,6549,605,1293,14464,63072,78588
Fiscal Analyst 1,1343,7,Strikeable,5503,6146,6866,643,1363,15073,66036,82392
Fiscal Analyst 1,1343,8,Strikeable,5771,6444,7206,673,1435,15734,69252,86472
Fiscal Analyst 1,1343,9,Strikeable,6051,6763,7206,712,1155,16424,72612,86472
Fiscal Analyst 1,1343,10,Strikeable,6350,6763,7206,413,856,17162,76200,86472
Fiscal Analyst 2,1344,1,Strikeable,5019,5598,6245,579,1226,13879,60228,74940
Fiscal Analyst 2,1344,2,Strikeable,5256,5861,6549,605,1293,14464,63072,78588
Fiscal Analyst 2,1344,3,Strikeable,5503,6146,6866,643,1363,15073,66036,82392
Fiscal Analyst 2,1344,4,Strikeable,5771,6444,7206,673,1435,15734,69252,86472
Fiscal Analyst 2,1344,5,Strikeable,6051,6763,7562,712,1511,16424,72612,90744
Fiscal Analyst 2,1344,6,Strikeable,6350,7097,7923,747,1573,17162,76200,95076
Fiscal Analyst 2,1344,7,Strikeable,6664,7436,8314,772,1650,17936,79968,99768
Fiscal Analyst 2,1344,8,Strikeable,6982,7803,8713,821,1731,18721,83784,104556
Fiscal Analyst 2,1344,9,Strikeable,7327,8177,8713,850,1386,19571,87924,104556
Fiscal Analyst 2,1344,10,Strikeable,7678,8177,8713,499,1035,20437,92136,104556
Fiscal Analyst 3,1345,1,Strikeable,5771,6444,7206,673,1435,15734,69252,86472
Fiscal Analyst 3,1345,2,Strikeable,6051,6763,7562,712,1511,16424,72612,90744
Fiscal Analyst 3,1345,3,Strikeable,6350,7097,7923,747,1573,17162,76200,95076
Fiscal Analyst 3,1345,4,Strikeable,6664,7436,8314,772,1650,17936,79968,99768
Fiscal Analyst 3,1345,5,Strikeable,6982,7803,8713,821,1731,18721,83784,104556
Fiscal Analyst 3,1345,6,Strikeable,7327,8177,9143,850,1816,19571,87924,109716
Fiscal Analyst 3,1345,7,Strikeable,7678,8581,9589,903,1911,20437,92136,115068
Fiscal Analyst 3,1345,8,Strikeable,8057,8999,10065,942,2008,21372,96684,120780
Fiscal Analyst 3,1345,9,Strikeable,8450,9447,10065,997,1615,22341,101400,120780
Fiscal Analyst 3,1345,10,Strikeable,8870,9447,10065,577,1195,23377,106440,120780
Fiscal Auditor 1,5641,1,Strikeable,4155,4639,5169,484,1014,11748,49860,62028
Fiscal Auditor 1,5641,2,Strikeable,4356,4851,5420,495,1064,12244,52272,65040
Fiscal Auditor 1,5641,3,Strikeable,4555,5086,5695,531,1140,12735,54660,68340
Fiscal Auditor 1,5641,4,Strikeable,4776,5345,5964,569,1188,13280,57312,71568
Fiscal Auditor 1,5641,5,Strikeable,5019,5598,6245,579,1226,13879,60228,74940
Fiscal Auditor 1,5641,6,Strikeable,5256,5861,6549,605,1293,14464,63072,78588
Fiscal Auditor 1,5641,7,Strikeable,5503,6146,6866,643,1363,15073,66036,82392
Fiscal Auditor 1,5641,8,Strikeable,5771,6444,7206,673,1435,15734,69252,86472
Fiscal Auditor 1,5641,9,Strikeable,6051,6763,7206,712,1155,16424,72612,86472
Fiscal Auditor 1,5641,10,Strikeable,6350,6763,7206,413,856,17162,76200,86472
Fish and Wildlife Technical Coordinator,8346,1,Strikeable,3790,4425,4943,635,1153,10848,45480,59316
Fish and Wildlife Technical Coordinator,8346,2,Strikeable,3964,4425,4943,461,979,11277,47568,59316
Fish and Wildlife Technical Coordinator,8346,3,Strikeable,4155,4639,5169,484,1014,11748,49860,62028
Fish and Wildlife Technical Coordinator,8346,4,Strikeable,4356,4851,5420,495,1064,12244,52272,65040
Fish and Wildlife Technical Coordinator,8346,5,Strikeable,4555,5086,5695,531,1140,12735,54660,68340
Fish and Wildlife Technical Coordinator,8346,6,Strikeable,4776,5345,5964,569,1188,13280,57312,71568
Fish and Wildlife Technical Coordinator,8346,7,Strikeable,5019,5598,6245,579,1226,13879,60228,74940
Fish and Wildlife Technical Coordinator,8346,8,Strikeable,5256,5861,6549,605,1293,14464,63072,78588
Fish and Wildlife Technical Coordinator,8346,9,Strikeable,5503,6146,6549,643,1046,15073,66036,78588
Fish and Wildlife Technical Coordinator,8346,10,Strikeable,5771,6146,6549,375,778,15734,69252,78588
Fish and Wildlife Technician,8341,1,Strikeable,3218,3709,4118,491,900,9437,38616,49416
Fish and Wildlife Technician,8341,2,Strikeable,3335,3709,4118,374,783,9726,40020,49416
Fish and Wildlife Technician,8341,3,Strikeable,3483,3865,4301,382,818,10091,41796,51612
Fish and Wildlife Technician,8341,4,Strikeable,3629,4036,4498,407,869,10451,43548,53976
Fish and Wildlife Technician,8341,5,Strikeable,3790,4222,4715,432,925,10848,45480,56580
Fish and Wildlife Technician,8341,6,Strikeable,3964,4425,4943,461,979,11277,47568,59316
Fish and Wildlife Technician,8341,7,Strikeable,4155,4639,5169,484,1014,11748,49860,62028
Fish and Wildlife Technician,8341,8,Strikeable,4356,4851,5420,495,1064,12244,52272,65040
Fish and Wildlife Technician,8341,9,Strikeable,4555,5086,5420,531,865,12735,54660,65040
Fish and Wildlife Technician,8341,10,Strikeable,4776,5086,5420,310,644,13280,57312,65040
Fish and Wildlife Technician Entry,8340,1,Strikeable,0,,,,,1500,0,
Fish and Wildlife Technician Entry,8340,2,Strikeable,0,,,,,1500,0,
Fish and Wildlife Technician Entry,8340,3,Strikeable,3005,3296,3652,291,647,8912,36060,43824
Fish and Wildlife Technician Entry,8340,4,Strikeable,3095,3427,3784,332,689,9134,37140,45408
Fish and Wildlife Technician Entry,8340,5,Strikeable,3218,3552,3952,334,734,9437,38616,47424
Fish and Wildlife Technician Entry,8340,6,Strikeable,3335,3709,4118,374,783,9726,40020,49416
Fish and Wildlife Technician Entry,8340,7,Strikeable,3483,3865,4301,382,818,10091,41796,51612
Fish and Wildlife Technician Entry,8340,8,Strikeable,3629,4036,4498,407,869,10451,43548,53976
Fish and Wildlife Technician Entry,8340,9,Strikeable,3790,4222,4498,432,708,10848,45480,53976
Fish and Wildlife Technician Entry,8340,10,Strikeable,3964,4222,4498,258,534,11277,47568,53976
Fish and Wildlife Technician Senior,8343,1,Strikeable,3483,3865,4301,382,818,10091,41796,51612
Fish and Wildlife Technician Senior,8343,2,Strikeable,3629,4036,4498,407,869,10451,43548,53976
Fish and Wildlife Technician Senior,8343,3,Strikeable,3790,4222,4715,432,925,10848,45480,56580
Fish and Wildlife Technician Senior,8343,4,Strikeable,3964,4425,4943,461,979,11277,47568,59316
Fish and Wildlife Technician Senior,8343,5,Strikeable,4155,4639,5169,484,1014,11748,49860,62028
Fish and Wildlife Technician Senior,8343,6,Strikeable,4356,4851,5420,495,1064,12244,52272,65040
Fish and Wildlife Technician Senior,8343,7,Strikeable,4555,5086,5695,531,1140,12735,54660,68340
Fish and Wildlife Technician Senior,8343,8,Strikeable,4776,5345,5964,569,1188,13280,57312,71568
Fish and Wildlife Technician Senior,8343,9,Strikeable,5019,5598,5964,579,945,13879,60228,71568
Fish and Wildlife Technician Senior,8343,10,Strikeable,5256,5598,5964,342,708,14464,63072,71568
Food Service Worker,9103,1,Strikeable,0,,,,,1500,0,
Food Service Worker,9103,2,Strikeable,0,,,,,1500,0,
Food Service Worker,9103,3,Strikeable,3005,3552,3952,547,947,8912,36060,47424
Food Service Worker,9103,4,Strikeable,3095,3552,3952,457,857,9134,37140,47424
Food Service Worker,9103,5,Strikeable,3218,3552,3952,334,734,9437,38616,47424
Food Service Worker,9103,6,Strikeable,3335,3709,4118,374,783,9726,40020,49416
Food Service Worker,9103,7,Strikeable,3483,3865,4301,382,818,10091,41796,51612
Food Service Worker,9103,8,Strikeable,3629,4036,4498,407,869,10451,43548,53976
Food Service Worker,9103,9,Strikeable,3790,4222,4498,432,708,10848,45480,53976
Food Service Worker,9103,10,Strikeable,3964,4222,4498,258,534,11277,47568,53976
Forest Crew Coordinator,8318,1,Strikeable,3483,4036,4498,553,1015,10091,41796,53976
Forest Crew Coordinator,8318,2,Strikeable,3629,4036,4498,407,869,10451,43548,53976
Forest Crew Coordinator,8318,3,Strikeable,3790,4222,4715,432,925,10848,45480,56580
Forest Crew Coordinator,8318,4,Strikeable,3964,4425,4943,461,979,11277,47568,59316
Forest Crew Coordinator,8318,5,Strikeable,4155,4639,5169,484,1014,11748,49860,62028
Forest Crew Coordinator,8318,6,Strikeable,4356,4851,5420,495,1064,12244,52272,65040
Forest Crew Coordinator,8318,7,Strikeable,4555,5086,5695,531,1140,12735,54660,68340
Forest Crew Coordinator,8318,8,Strikeable,4776,5345,5964,569,1188,13280,57312,71568
Forest Crew Coordinator,8318,9,Strikeable,5019,5598,5964,579,945,13879,60228,71568
Forest Crew Coordinator,8318,10,Strikeable,5256,5598,5964,342,708,14464,63072,71568
Forest Lookout,8353,1,Strikeable,0,,,,,1500,0,
Forest Lookout,8353,2,Strikeable,0,,,,,1500,0,
Forest Lookout,8353,3,Strikeable,0,,,,,1500,0,
Forest Lookout,8353,4,Strikeable,0,,,,,1500,0,
Forest Lookout,8353,5,Strikeable,3005,3427,3784,422,779,8912,36060,45408
Forest Lookout,8353,6,Strikeable,3095,3427,3784,332,689,9134,37140,45408
Forest Lookout,8353,7,Strikeable,3218,3552,3952,334,734,9437,38616,47424
Forest Lookout,8353,8,Strikeable,3335,3709,4118,374,783,9726,40020,49416
Forest Lookout,8353,9,Strikeable,3483,3865,4118,382,635,10091,41796,49416
Forest Lookout,8353,10,Strikeable,3629,3865,4118,236,489,10451,43548,49416
Forest Management Technician,8311,1,Strikeable,3095,3552,3952,457,857,9134,37140,47424
Forest Management Technician,8311,2,Strikeable,3218,3552,3952,334,734,9437,38616,47424
Forest Management Technician,8311,3,Strikeable,3335,3709,4118,374,783,9726,40020,49416
Forest Management Technician,8311,4,Strikeable,3483,3865,4301,382,818,10091,41796,51612
Forest Management Technician,8311,5,Strikeable,3629,4036,4498,407,869,10451,43548,53976
Forest Management Technician,8311,6,Strikeable,3790,4222,4715,432,925,10848,45480,56580
Forest Management Technician,8311,7,Strikeable,3964,4425,4943,461,979,11277,47568,59316
Forest Management Technician,8311,8,Strikeable,4155,4639,5169,484,1014,11748,49860,62028
Forest Management Technician,8311,9,Strikeable,4356,4851,5169,495,813,12244,52272,62028
Forest Management Technician,8311,10,Strikeable,4555,4851,5169,296,614,12735,54660,62028
Forest Officer,8357,1,Strikeable,4155,4639,5169,484,1014,11748,49860,62028
Forest Officer,8357,2,Strikeable,4356,4851,5420,495,1064,12244,52272,65040
Forest Officer,8357,3,Strikeable,4555,5086,5695,531,1140,12735,54660,68340
Forest Officer,8357,4,Strikeable,4776,5345,5964,569,1188,13280,57312,71568
Forest Officer,8357,5,Strikeable,5019,5598,6245,579,1226,13879,60228,74940
Forest Officer,8357,6,Strikeable,5256,5861,6549,605,1293,14464,63072,78588
Forest Officer,8357,7,Strikeable,5503,6146,6866,643,1363,15073,66036,82392
Forest Officer,8357,8,Strikeable,5771,6444,7206,673,1435,15734,69252,86472
Forest Officer,8357,9,Strikeable,6051,6763,7206,712,1155,16424,72612,86472
Forest Officer,8357,10,Strikeable,6350,6763,7206,413,856,17162,76200,86472
Geologist 2,3531,1,Strikeable,4776,5345,5964,569,1188,13280,57312,71568
Geologist 2,3531,2,Strikeable,5019,5598,6245,579,1226,13879,60228,74940
Geologist 2,3531,3,Strikeable,5256,5861,6549,605,1293,14464,63072,78588
Geologist 2,3531,4,Strikeable,5503,6146,6866,643,1363,15073,66036,82392
Geologist 2,3531,5,Strikeable,5771,6444,7206,673,1435,15734,69252,86472
Geologist 2,3531,6,Strikeable,6051,6763,7562,712,1511,16424,72612,90744
Geologist 2,3531,7,Strikeable,6350,7097,7923,747,1573,17162,76200,95076
Geologist 2,3531,8,Strikeable,6664,7436,8314,772,1650,17936,79968,99768
Geologist 2,3531,9,Strikeable,6982,7803,8314,821,1332,18721,83784,99768
Geologist 2,3531,10,Strikeable,7327,7803,8314,476,987,19571,87924,99768
Governmental Auditor 1,5646,1,Strikeable,4356,4851,5420,495,1064,12244,52272,65040
Governmental Auditor 1,5646,2,Strikeable,4555,5086,5695,531,1140,12735,54660,68340
Governmental Auditor 1,5646,3,Strikeable,4776,5345,5964,569,1188,13280,57312,71568
Governmental Auditor 1,5646,4,Strikeable,5019,5598,6245,579,1226,13879,60228,74940
Governmental Auditor 1,5646,5,Strikeable,5256,5861,6549,605,1293,14464,63072,78588
Governmental Auditor 1,5646,6,Strikeable,5503,6146,6866,643,1363,15073,66036,82392
Governmental Auditor 1,5646,7,Strikeable,5771,6444,7206,673,1435,15734,69252,86472
Governmental Auditor 1,5646,8,Strikeable,6051,6763,7562,712,1511,16424,72612,90744
Governmental Auditor 1,5646,9,Strikeable,6350,7097,7562,747,1212,17162,76200,90744
Governmental Auditor 1,5646,10,Strikeable,6664,7097,7562,433,898,17936,79968,90744
Governmental Auditor 2,5647,1,Strikeable,4776,5345,5964,569,1188,13280,57312,71568
Governmental Auditor 2,5647,2,Strikeable,5019,5598,6245,579,1226,13879,60228,74940
Governmental Auditor 2,5647,3,Strikeable,5256,5861,6549,605,1293,14464,63072,78588
Governmental Auditor 2,5647,4,Strikeable,5503,6146,6866,643,1363,15073,66036,82392
Governmental Auditor 2,5647,5,Strikeable,5771,6444,7206,673,1435,15734,69252,86472
Governmental Auditor 2,5647,6,Strikeable,6051,6763,7562,712,1511,16424,72612,90744
Governmental Auditor 2,5647,7,Strikeable,6350,7097,7923,747,1573,17162,76200,95076
Governmental Auditor 2,5647,8,Strikeable,6664,7436,8314,772,1650,17936,79968,99768
Governmental Auditor 2,5647,9,Strikeable,6982,7803,8314,821,1332,18721,83784,99768
Governmental Auditor 2,5647,10,Strikeable,7327,7803,8314,476,987,19571,87924,99768
Governmental Auditor 3,5648,1,Strikeable,5503,6146,6866,643,1363,15073,66036,82392
Governmental Auditor 3,5648,2,Strikeable,5771,6444,7206,673,1435,15734,69252,86472
Governmental Auditor 3,5648,3,Strikeable,6051,6763,7562,712,1511,16424,72612,90744
Governmental Auditor 3,5648,4,Strikeable,6350,7097,7923,747,1573,17162,76200,95076
Governmental Auditor 3,5648,5,Strikeable,6664,7436,8314,772,1650,17936,79968,99768
Governmental Auditor 3,5648,6,Strikeable,6982,7803,8713,821,1731,18721,83784,104556
Governmental Auditor 3,5648,7,Strikeable,7327,8177,9143,850,1816,19571,87924,109716
Governmental Auditor 3,5648,8,Strikeable,7678,8581,9589,903,1911,20437,92136,115068
Governmental Auditor 3,5648,9,Strikeable,8057,8999,9589,942,1532,21372,96684,115068
Governmental Auditor 3,5648,10,Strikeable,8450,8999,9589,549,1139,22341,101400,115068
Grounds Maintenance Worker 1,4109,1,Strikeable,0,,,,,1500,0,
Grounds Maintenance Worker 1,4109,2,Strikeable,3005,3427,3784,422,779,8912,36060,45408
Grounds Maintenance Worker 1,4109,3,Strikeable,3095,3427,3784,332,689,9134,37140,45408
Grounds Maintenance Worker 1,4109,4,Strikeable,3218,3552,3952,334,734,9437,38616,47424
Grounds Maintenance Worker 1,4109,5,Strikeable,3335,3709,4118,374,783,9726,40020,49416
Grounds Maintenance Worker 1,4109,6,Strikeable,3483,3865,4301,382,818,10091,41796,51612
Grounds Maintenance Worker 1,4109,7,Strikeable,3629,4036,4498,407,869,10451,43548,53976
Grounds Maintenance Worker 1,4109,8,Strikeable,3790,4222,4715,432,925,10848,45480,56580
Grounds Maintenance Worker 1,4109,9,Strikeable,3964,4425,4715,461,751,11277,47568,56580
Grounds Maintenance Worker 1,4109,10,Strikeable,4155,4425,4715,270,560,11748,49860,56580
Grounds Maintenance Worker 2,4110,1,Strikeable,3218,3709,4118,491,900,9437,38616,49416
Grounds Maintenance Worker 2,4110,2,Strikeable,3335,3709,4118,374,783,9726,40020,49416
Grounds Maintenance Worker 2,4110,3,Strikeable,3483,3865,4301,382,818,10091,41796,51612
Grounds Maintenance Worker 2,4110,4,Strikeable,3629,4036,4498,407,869,10451,43548,53976
Grounds Maintenance Worker 2,4110,5,Strikeable,3790,4222,4715,432,925,10848,45480,56580
Grounds Maintenance Worker 2,4110,6,Strikeable,3964,4425,4943,461,979,11277,47568,59316
Grounds Maintenance Worker 2,4110,7,Strikeable,4155,4639,5169,484,1014,11748,49860,62028
Grounds Maintenance Worker 2,4110,8,Strikeable,4356,4851,5420,495,1064,12244,52272,65040
Grounds Maintenance Worker 2,4110,9,Strikeable,4555,5086,5420,531,865,12735,54660,65040
Grounds Maintenance Worker 2,4110,10,Strikeable,4776,5086,5420,310,644,13280,57312,65040
Group Life Coordinator 1,6750,1,Strikeable,3005,3552,3952,547,947,8912,36060,47424
Group Life Coordinator 1,6750,2,Strikeable,3095,3552,3952,457,857,9134,37140,47424
Group Life Coordinator 1,6750,3,Strikeable,3218,3552,3952,334,734,9437,38616,47424
Group Life Coordinator 1,6750,4,Strikeable,3335,3709,4118,374,783,9726,40020,49416
Group Life Coordinator 1,6750,5,Strikeable,3483,3865,4301,382,818,10091,41796,51612
Group Life Coordinator 1,6750,6,Strikeable,3629,4036,4498,407,869,10451,43548,53976
Group Life Coordinator 1,6750,7,Strikeable,3790,4222,4715,432,925,10848,45480,56580
Group Life Coordinator 1,6750,8,Strikeable,3964,4425,4943,461,979,11277,47568,59316
Group Life Coordinator 1,6750,9,Strikeable,4155,4639,4943,484,788,11748,49860,59316
Group Life Coordinator 1,6750,10,Strikeable,4356,4639,4943,283,587,12244,52272,59316
Group Life Coordinator 2,6751,1,Strikeable,3483,4222,4715,739,1232,10091,41796,56580
Group Life Coordinator 2,6751,2,Strikeable,3629,4222,4715,593,1086,10451,43548,56580
Group Life Coordinator 2,6751,3,Strikeable,3790,4222,4715,432,925,10848,45480,56580
Group Life Coordinator 2,6751,4,Strikeable,3964,4425,4943,461,979,11277,47568,59316
Group Life Coordinator 2,6751,5,Strikeable,4155,4639,5169,484,1014,11748,49860,62028
Group Life Coordinator 2,6751,6,Strikeable,4356,4851,5420,495,1064,12244,52272,65040
Group Life Coordinator 2,6751,7,Strikeable,4555,5086,5695,531,1140,12735,54660,68340
Group Life Coordinator 2,6751,8,Strikeable,4776,5345,5964,569,1188,13280,57312,71568
Group Life Coordinator 2,6751,9,Strikeable,5019,5598,5964,579,945,13879,60228,71568
Group Life Coordinator 2,6751,10,Strikeable,5256,5598,5964,342,708,14464,63072,71568
Hairdresser,9300,1,Strikeable,0,,,,,1500,0,
Hairdresser,9300,2,Strikeable,0,,,,,1500,0,
Hairdresser,9300,3,Strikeable,0,,,,,1500,0,
Hairdresser,9300,4,Strikeable,0,,,,,1500,0,
Hairdresser,9300,5,Strikeable,3335,4036,4498,701,1163,9726,40020,53976
Hairdresser,9300,6,Strikeable,3483,4036,4498,553,1015,10091,41796,53976
Hairdresser,9300,7,Strikeable,3629,4036,4498,407,869,10451,43548,53976
Hairdresser,9300,8,Strikeable,3790,4222,4715,432,925,10848,45480,56580
Hairdresser,9300,9,Strikeable,3964,4425,4715,461,751,11277,47568,56580
Hairdresser,9300,10,Strikeable,4155,4425,4715,270,560,11748,49860,56580
Health Care Investigator/Advisor,5911,1,Strikeable,4776,5345,5964,569,1188,13280,57312,71568
Health Care Investigator/Advisor,5911,2,Strikeable,5019,5598,6245,579,1226,13879,60228,74940
Health Care Investigator/Advisor,5911,3,Strikeable,5256,5861,6549,605,1293,14464,63072,78588
Health Care Investigator/Advisor,5911,4,Strikeable,5503,6146,6866,643,1363,15073,66036,82392
Health Care Investigator/Advisor,5911,5,Strikeable,5771,6444,7206,673,1435,15734,69252,86472
Health Care Investigator/Advisor,5911,6,Strikeable,6051,6763,7562,712,1511,16424,72612,90744
Health Care Investigator/Advisor,5911,7,Strikeable,6350,7097,7923,747,1573,17162,76200,95076
Health Care Investigator/Advisor,5911,8,Strikeable,6664,7436,8314,772,1650,17936,79968,99768
Health Care Investigator/Advisor,5911,9,Strikeable,6982,7803,8314,821,1332,18721,83784,99768
Health Care Investigator/Advisor,5911,10,Strikeable,7327,7803,8314,476,987,19571,87924,99768
Health Information Specialist,15,1,Strikeable,3335,3865,4301,530,966,9726,40020,51612
Health Information Specialist,15,2,Strikeable,3483,3865,4301,382,818,10091,41796,51612
Health Information Specialist,15,3,Strikeable,3629,4036,4498,407,869,10451,43548,53976
Health Information Specialist,15,4,Strikeable,3790,4222,4715,432,925,10848,45480,56580
Health Information Specialist,15,5,Strikeable,3964,4425,4943,461,979,11277,47568,59316
Health Information Specialist,15,6,Strikeable,4155,4639,5169,484,1014,11748,49860,62028
Health Information Specialist,15,7,Strikeable,4356,4851,5420,495,1064,12244,52272,65040
Health Information Specialist,15,8,Strikeable,4555,5086,5695,531,1140,12735,54660,68340
Health Information Specialist,15,9,Strikeable,4776,5345,5695,569,919,13280,57312,68340
Health Information Specialist,15,10,Strikeable,5019,5345,5695,326,676,13879,60228,68340
Heavy Equipment Technician 1,4437,1,Strikeable,0,,,,,1500,0,
Heavy Equipment Technician 1,4437,2,Strikeable,0,,,,,1500,0,
Heavy Equipment Technician 1,4437,3,Strikeable,0,,,,,1500,0,
Heavy Equipment Technician 1,4437,4,Strikeable,0,,,,,1500,0,
Heavy Equipment Technician 1,4437,5,Strikeable,5193,5795,6469,602,1276,14308,62316,77628
Heavy Equipment Technician 1,4437,6,Strikeable,5441,6072,6782,631,1341,14920,65292,81384
Heavy Equipment Technician 1,4437,7,Strikeable,5701,6366,7105,665,1404,15561,68412,85260
Heavy Equipment Technician 1,4437,8,Strikeable,5977,6668,7442,691,1465,16242,71724,89304
Heavy Equipment Technician 1,4437,9,Strikeable,6261,6984,7442,723,1181,16942,75132,89304
Heavy Equipment Technician 1,4437,10,Strikeable,6558,6984,7442,426,884,17675,78696,89304
Heavy Equipment Technician 2,4438,1,Strikeable,0,,,,,1500,0,
Heavy Equipment Technician 2,4438,2,Strikeable,0,,,,,1500,0,
Heavy Equipment Technician 2,4438,3,Strikeable,0,,,,,1500,0,
Heavy Equipment Technician 2,4438,4,Strikeable,0,,,,,1500,0,
Heavy Equipment Technician 2,4438,5,Strikeable,5771,6444,7206,673,1435,15734,69252,86472
Heavy Equipment Technician 2,4438,6,Strikeable,6051,6763,7562,712,1511,16424,72612,90744
Heavy Equipment Technician 2,4438,7,Strikeable,6350,7097,7923,747,1573,17162,76200,95076
Heavy Equipment Technician 2,4438,8,Strikeable,6664,7436,8303,772,1639,17936,79968,99636
Heavy Equipment Technician 2,4438,9,Strikeable,6982,7793,8303,811,1321,18721,83784,99636
Heavy Equipment Technician 2,4438,10,Strikeable,7317,7793,8303,476,986,19547,87804,99636
Human Services Assistant 2,6606,1,Strikeable,3095,3552,3952,457,857,9134,37140,47424
Human Services Assistant 2,6606,2,Strikeable,3218,3552,3952,334,734,9437,38616,47424
Human Services Assistant 2,6606,3,Strikeable,3335,3709,4118,374,783,9726,40020,49416
Human Services Assistant 2,6606,4,Strikeable,3483,3865,4301,382,818,10091,41796,51612
Human Services Assistant 2,6606,5,Strikeable,3629,4036,4498,407,869,10451,43548,53976
Human Services Assistant 2,6606,6,Strikeable,3790,4222,4715,432,925,10848,45480,56580
Human Services Assistant 2,6606,7,Strikeable,3964,4425,4943,461,979,11277,47568,59316
Human Services Assistant 2,6606,8,Strikeable,4155,4639,5169,484,1014,11748,49860,62028
Human Services Assistant 2,6606,9,Strikeable,4356,4851,5169,495,813,12244,52272,62028
Human Services Assistant 2,6606,10,Strikeable,4555,4851,5169,296,614,12735,54660,62028
Human Services Case Manager,6630,1,Strikeable,3790,4425,4943,635,1153,10848,45480,59316
Human Services Case Manager,6630,2,Strikeable,3964,4425,4943,461,979,11277,47568,59316
Human Services Case Manager,6630,3,Strikeable,4155,4639,5169,484,1014,11748,49860,62028
Human Services Case Manager,6630,4,Strikeable,4356,4851,5420,495,1064,12244,52272,65040
Human Services Case Manager,6630,5,Strikeable,4555,5086,5695,531,1140,12735,54660,68340
Human Services Case Manager,6630,6,Strikeable,4776,5345,5964,569,1188,13280,57312,71568
Human Services Case Manager,6630,7,Strikeable,5019,5598,6245,579,1226,13879,60228,74940
Human Services Case Manager,6630,8,Strikeable,5256,5861,6549,605,1293,14464,63072,78588
Human Services Case Manager,6630,9,Strikeable,5503,6146,6549,643,1046,15073,66036,78588
Human Services Case Manager,6630,10,Strikeable,5771,6146,6549,375,778,15734,69252,78588
Human Services Specialist 1,6657,1,Strikeable,3005,3427,3784,422,779,8912,36060,45408
Human Services Specialist 1,6657,2,Strikeable,3095,3427,3784,332,689,9134,37140,45408
Human Services Specialist 1,6657,3,Strikeable,3218,3552,3952,334,734,9437,38616,47424
Human Services Specialist 1,6657,4,Strikeable,3335,3709,4118,374,783,9726,40020,49416
Human Services Specialist 1,6657,5,Strikeable,3483,3865,4301,382,818,10091,41796,51612
Human Services Specialist 1,6657,6,Strikeable,3629,4036,4498,407,869,10451,43548,53976
Human Services Specialist 1,6657,7,Strikeable,3790,4222,4715,432,925,10848,45480,56580
Human Services Specialist 1,6657,8,Strikeable,3964,4425,4943,461,979,11277,47568,59316
Human Services Specialist 1,6657,9,Strikeable,4155,4639,4943,484,788,11748,49860,59316
Human Services Specialist 1,6657,10,Strikeable,4356,4639,4943,283,587,12244,52272,59316
Human Services Specialist 2,6658,1,Strikeable,3218,3709,4118,491,900,9437,38616,49416
Human Services Specialist 2,6658,2,Strikeable,3335,3709,4118,374,783,9726,40020,49416
Human Services Specialist 2,6658,3,Strikeable,3483,3865,4301,382,818,10091,41796,51612
Human Services Specialist 2,6658,4,Strikeable,3629,4036,4498,407,869,10451,43548,53976
Human Services Specialist 2,6658,5,Strikeable,3790,4222,4715,432,925,10848,45480,56580
Human Services Specialist 2,6658,6,Strikeable,3964,4425,4943,461,979,11277,47568,59316
Human Services Specialist 2,6658,7,Strikeable,4155,4639,5169,484,1014,11748,49860,62028
Human Services Specialist 2,6658,8,Strikeable,4356,4851,5420,495,1064,12244,52272,65040
Human Services Specialist 2,6658,9,Strikeable,4555,5086,5420,531,865,12735,54660,65040
Human Services Specialist 2,6658,10,Strikeable,4776,5086,5420,310,644,13280,57312,65040
Human Services Specialist 3,6659,1,Strikeable,3483,4036,4498,553,1015,10091,41796,53976
Human Services Specialist 3,6659,2,Strikeable,3629,4036,4498,407,869,10451,43548,53976
Human Services Specialist 3,6659,3,Strikeable,3790,4222,4715,432,925,10848,45480,56580
Human Services Specialist 3,6659,4,Strikeable,3964,4425,4943,461,979,11277,47568,59316
Human Services Specialist 3,6659,5,Strikeable,4155,4639,5169,484,1014,11748,49860,62028
Human Services Specialist 3,6659,6,Strikeable,4356,4851,5420,495,1064,12244,52272,65040
Human Services Specialist 3,6659,7,Strikeable,4555,5086,5695,531,1140,12735,54660,68340
Human Services Specialist 3,6659,8,Strikeable,4776,5345,5964,569,1188,13280,57312,71568
Human Services Specialist 3,6659,9,Strikeable,5019,5598,5964,579,945,13879,60228,71568
Human Services Specialist 3,6659,10,Strikeable,5256,5598,5964,342,708,14464,63072,71568
Human Services Specialist 4,6660,1,Strikeable,3964,4425,4943,461,979,11277,47568,59316
Human Services Specialist 4,6660,2,Strikeable,4155,4639,5169,484,1014,11748,49860,62028
Human Services Specialist 4,6660,3,Strikeable,4356,4851,5420,495,1064,12244,52272,65040
Human Services Specialist 4,6660,4,Strikeable,4555,5086,5695,531,1140,12735,54660,68340
Human Services Specialist 4,6660,5,Strikeable,4776,5345,5964,569,1188,13280,57312,71568
Human Services Specialist 4,6660,6,Strikeable,5019,5598,6245,579,1226,13879,60228,74940
Human Services Specialist 4,6660,7,Strikeable,5256,5861,6549,605,1293,14464,63072,78588
Human Services Specialist 4,6660,8,Strikeable,5503,6146,6866,643,1363,15073,66036,82392
Human Services Specialist 4,6660,9,Strikeable,5771,6444,6866,673,1095,15734,69252,82392
Human Services Specialist 4,6660,10,Strikeable,6051,6444,6866,393,815,16424,72612,82392
Incident Response Operations Specialist,4165,1,Strikeable,3629,4222,4715,593,1086,10451,43548,56580
Incident Response Operations Specialist,4165,2,Strikeable,3790,4222,4715,432,925,10848,45480,56580
Incident Response Operations Specialist,4165,3,Strikeable,3964,4425,4943,461,979,11277,47568,59316
Incident Response Operations Specialist,4165,4,Strikeable,4155,4639,5169,484,1014,11748,49860,62028
Incident Response Operations Specialist,4165,5,Strikeable,4356,4851,5420,495,1064,12244,52272,65040
Incident Response Operations Specialist,4165,6,Strikeable,4555,5086,5695,531,1140,12735,54660,68340
Incident Response Operations Specialist,4165,7,Strikeable,4776,5345,5964,569,1188,13280,57312,71568
Incident Response Operations Specialist,4165,8,Strikeable,5019,5598,6245,579,1226,13879,60228,74940
Incident Response Operations Specialist,4165,9,Strikeable,5256,5861,6245,605,989,14464,63072,74940
Incident Response Operations Specialist,4165,10,Strikeable,5503,5861,6245,358,742,15073,66036,74940
Industrial Hygienist 2,5706,1,Strikeable,5019,5598,6245,579,1226,13879,60228,74940
Industrial Hygienist 2,5706,2,Strikeable,5256,5861,6549,605,1293,14464,63072,78588
Industrial Hygienist 2,5706,3,Strikeable,5503,6146,6866,643,1363,15073,66036,82392
Industrial Hygienist 2,5706,4,Strikeable,5771,6444,7206,673,1435,15734,69252,86472
Industrial Hygienist 2,5706,5,Strikeable,6051,6763,7562,712,1511,16424,72612,90744
Industrial Hygienist 2,5706,6,Strikeable,6350,7097,7923,747,1573,17162,76200,95076
Industrial Hygienist 2,5706,7,Strikeable,6664,7436,8314,772,1650,17936,79968,99768
Industrial Hygienist 2,5706,8,Strikeable,6982,7803,8713,821,1731,18721,83784,104556
Industrial Hygienist 2,5706,9,Strikeable,7327,8177,8713,850,1386,19571,87924,104556
Industrial Hygienist 2,5706,10,Strikeable,7678,8177,8713,499,1035,20437,92136,104556
Industrial Hygienist 3,5707,1,Strikeable,5503,6146,6866,643,1363,15073,66036,82392
Industrial Hygienist 3,5707,2,Strikeable,5771,6444,7206,673,1435,15734,69252,86472
Industrial Hygienist 3,5707,3,Strikeable,6051,6763,7562,712,1511,16424,72612,90744
Industrial Hygienist 3,5707,4,Strikeable,6350,7097,7923,747,1573,17162,76200,95076
Industrial Hygienist 3,5707,5,Strikeable,6664,7436,8314,772,1650,17936,79968,99768
Industrial Hygienist 3,5707,6,Strikeable,6982,7803,8713,821,1731,18721,83784,104556
Industrial Hygienist 3,5707,7,Strikeable,7327,8177,9143,850,1816,19571,87924,109716
Industrial Hygienist 3,5707,8,Strikeable,7678,8581,9589,903,1911,20437,92136,115068
Industrial Hygienist 3,5707,9,Strikeable,8057,8999,9589,942,1532,21372,96684,115068
Industrial Hygienist 3,5707,10,Strikeable,8450,8999,9589,549,1139,22341,101400,115068
Industrial Hygienist 4,5708,1,Strikeable,6051,6763,7562,712,1511,16424,72612,90744
Industrial Hygienist 4,5708,2,Strikeable,6350,7097,7923,747,1573,17162,76200,95076
Industrial Hygienist 4,5708,3,Strikeable,6664,7436,8314,772,1650,17936,79968,99768
Industrial Hygienist 4,5708,4,Strikeable,6982,7803,8713,821,1731,18721,83784,104556
Industrial Hygienist 4,5708,5,Strikeable,7327,8177,9143,850,1816,19571,87924,109716
Industrial Hygienist 4,5708,6,Strikeable,7678,8581,9589,903,1911,20437,92136,115068
Industrial Hygienist 4,5708,7,Strikeable,8057,8999,10065,942,2008,21372,96684,120780
Industrial Hygienist 4,5708,8,Strikeable,8450,9447,10545,997,2095,22341,101400,126540
Industrial Hygienist 4,5708,9,Strikeable,8870,9897,10545,1027,1675,23377,106440,126540
Industrial Hygienist 4,5708,10,Strikeable,9293,9897,10545,604,1252,24420,111516,126540
Information Systems Specialist 2,1483,1,Strikeable,3790,4425,4943,635,1153,10848,45480,59316
Information Systems Specialist 2,1483,2,Strikeable,3964,4425,4943,461,979,11277,47568,59316
Information Systems Specialist 2,1483,3,Strikeable,4155,4639,5169,484,1014,11748,49860,62028
Information Systems Specialist 2,1483,4,Strikeable,4356,4851,5420,495,1064,12244,52272,65040
Information Systems Specialist 2,1483,5,Strikeable,4555,5086,5695,531,1140,12735,54660,68340
Information Systems Specialist 2,1483,6,Strikeable,4776,5345,5964,569,1188,13280,57312,71568
Information Systems Specialist 2,1483,7,Strikeable,5019,5598,6245,579,1226,13879,60228,74940
Information Systems Specialist 2,1483,8,Strikeable,5256,5861,6549,605,1293,14464,63072,78588
Information Systems Specialist 2,1483,9,Strikeable,5503,6146,6549,643,1046,15073,66036,78588
Information Systems Specialist 2,1483,10,Strikeable,5771,6146,6549,375,778,15734,69252,78588
Information Systems Specialist 3,1483,1,Strikeable,4356,4851,5420,495,1064,12244,52272,65040
Information Systems Specialist 3,1483,2,Strikeable,4555,5086,5695,531,1140,12735,54660,68340
Information Systems Specialist 3,1483,3,Strikeable,4776,5345,5964,569,1188,13280,57312,71568
Information Systems Specialist 3,1483,4,Strikeable,5019,5598,6245,579,1226,13879,60228,74940
Information Systems Specialist 3,1483,5,Strikeable,5256,5861,6549,605,1293,14464,63072,78588
Information Systems Specialist 3,1483,6,Strikeable,5503,6146,6866,643,1363,15073,66036,82392
Information Systems Specialist 3,1483,7,Strikeable,5771,6444,7206,673,1435,15734,69252,86472
Information Systems Specialist 3,1483,8,Strikeable,6051,6763,7562,712,1511,16424,72612,90744
Information Systems Specialist 3,1483,9,Strikeable,6350,7097,7562,747,1212,17162,76200,90744
Information Systems Specialist 3,1483,10,Strikeable,6664,7097,7562,433,898,17936,79968,90744
Information Systems Specialist 4,1484,1,Strikeable,4555,5086,5695,531,1140,12735,54660,68340
Information Systems Specialist 4,1484,2,Strikeable,4776,5345,5964,569,1188,13280,57312,71568
Information Systems Specialist 4,1484,3,Strikeable,5019,5598,6245,579,1226,13879,60228,74940
Information Systems Specialist 4,1484,4,Strikeable,5256,5861,6549,605,1293,14464,63072,78588
Information Systems Specialist 4,1484,5,Strikeable,5503,6146,6866,643,1363,15073,66036,82392
Information Systems Specialist 4,1484,6,Strikeable,5771,6444,7206,673,1435,15734,69252,86472
Information Systems Specialist 4,1484,7,Strikeable,6051,6763,7562,712,1511,16424,72612,90744
Information Systems Specialist 4,1484,8,Strikeable,6350,7097,7923,747,1573,17162,76200,95076
Information Systems Specialist 4,1484,9,Strikeable,6664,7436,7923,772,1259,17936,79968,95076
Information Systems Specialist 4,1484,10,Strikeable,6982,7436,7923,454,941,18721,83784,95076
Information Systems Specialist 5,1485,1,Strikeable,5256,5861,6549,605,1293,14464,63072,78588
Information Systems Specialist 5,1485,2,Strikeable,5503,6146,6866,643,1363,15073,66036,82392
Information Systems Specialist 5,1485,3,Strikeable,5771,6444,7206,673,1435,15734,69252,86472
Information Systems Specialist 5,1485,4,Strikeable,6051,6763,7562,712,1511,16424,72612,90744
Information Systems Specialist 5,1485,5,Strikeable,6350,7097,7923,747,1573,17162,76200,95076
Information Systems Specialist 5,1485,6,Strikeable,6664,7436,8314,772,1650,17936,79968,99768
Information Systems Specialist 5,1485,7,Strikeable,6982,7803,8713,821,1731,18721,83784,104556
Information Systems Specialist 5,1485,8,Strikeable,7327,8177,9143,850,1816,19571,87924,109716
Information Systems Specialist 5,1485,9,Strikeable,7678,8581,9143,903,1465,20437,92136,109716
Information Systems Specialist 5,1485,10,Strikeable,8057,8581,9143,524,1086,21372,96684,109716
Information Systems Specialist 6,1486,1,Strikeable,5503,6146,6866,643,1363,15073,66036,82392
Information Systems Specialist 6,1486,2,Strikeable,5771,6444,7206,673,1435,15734,69252,86472
Information Systems Specialist 6,1486,3,Strikeable,6051,6763,7562,712,1511,16424,72612,90744
Information Systems Specialist 6,1486,4,Strikeable,6350,7097,7923,747,1573,17162,76200,95076
Information Systems Specialist 6,1486,5,Strikeable,6664,7436,8314,772,1650,17936,79968,99768
Information Systems Specialist 6,1486,6,Strikeable,6982,7803,8713,821,1731,18721,83784,104556
Information Systems Specialist 6,1486,7,Strikeable,7327,8177,9143,850,1816,19571,87924,109716
Information Systems Specialist 6,1486,8,Strikeable,7678,8581,9589,903,1911,20437,92136,115068
Information Systems Specialist 6,1486,9,Strikeable,8057,8999,9589,942,1532,21372,96684,115068
Information Systems Specialist 6,1486,10,Strikeable,8450,8999,9589,549,1139,22341,101400,115068
Information Systems Specialist 7,1487,1,Strikeable,5503,6146,6866,643,1363,15073,66036,82392
Information Systems Specialist 7,1487,2,Strikeable,5771,6444,7206,673,1435,15734,69252,86472
Information Systems Specialist 7,1487,3,Strikeable,6051,6763,7562,712,1511,16424,72612,90744
Information Systems Specialist 7,1487,4,Strikeable,6350,7097,7923,747,1573,17162,76200,95076
Information Systems Specialist 7,1487,5,Strikeable,6664,7436,8314,772,1650,17936,79968,99768
Information Systems Specialist 7,1487,6,Strikeable,6982,7803,8713,821,1731,18721,83784,104556
Information Systems Specialist 7,1487,7,Strikeable,7327,8177,9143,850,1816,19571,87924,109716
Information Systems Specialist 7,1487,8,Strikeable,7678,8581,9589,903,1911,20437,92136,115068
Information Systems Specialist 7,1487,9,Strikeable,8057,8999,9589,942,1532,21372,96684,115068
Information Systems Specialist 7,1487,10,Strikeable,8450,8999,9589,549,1139,22341,101400,115068
Information Systems Specialist 8,1488,1,Strikeable,6051,6763,7562,712,1511,16424,72612,90744
Information Systems Specialist 8,1488,2,Strikeable,6350,7097,7923,747,1573,17162,76200,95076
Information Systems Specialist 8,1488,3,Strikeable,6664,7436,8314,772,1650,17936,79968,99768
Information Systems Specialist 8,1488,4,Strikeable,6982,7803,8713,821,1731,18721,83784,104556
Information Systems Specialist 8,1488,5,Strikeable,7327,8177,9143,850,1816,19571,87924,109716
Information Systems Specialist 8,1488,6,Strikeable,7678,8581,9589,903,1911,20437,92136,115068
Information Systems Specialist 8,1488,7,Strikeable,8057,8999,10065,942,2008,21372,96684,120780
Information Systems Specialist 8,1488,8,Strikeable,8450,9447,10545,997,2095,22341,101400,126540
Information Systems Specialist 8,1488,9,Strikeable,8870,9897,10545,1027,1675,23377,106440,126540
Information Systems Specialist 8,1488,10,Strikeable,9293,9897,10545,604,1252,24420,111516,126540
Institution Registered Nurse,6314,1,Strikeable,6756,7534,8409,778,1653,18163,81072,100908
Institution Registered Nurse,6314,2,Strikeable,7074,7892,8810,818,1736,18947,84888,105720
Institution Registered Nurse,6314,3,Strikeable,7410,8269,9226,859,1816,19776,88920,110712
Institution Registered Nurse,6314,4,Strikeable,7764,8658,9667,894,1903,20649,93168,116004
Institution Registered Nurse,6314,5,Strikeable,8130,9073,10172,943,2042,21552,97560,122064
Institution Registered Nurse,6314,6,Strikeable,8519,9547,10604,1028,2085,22511,102228,127248
Institution Registered Nurse,6314,7,Strikeable,8964,9952,11108,988,2144,23609,107568,133296
Institution Registered Nurse,6314,8,Strikeable,9345,10425,11636,1080,2291,24549,112140,139632
Institution Registered Nurse,6314,9,Strikeable,9789,10921,11636,1132,1847,25644,117468,139632
Institution Registered Nurse,6314,10,Strikeable,10254,10921,11636,667,1382,26791,123048,139632
Insurance Examiner,5748,1,Strikeable,5771,6444,7206,673,1435,15734,69252,86472
Insurance Examiner,5748,2,Strikeable,6051,6763,7562,712,1511,16424,72612,90744
Insurance Examiner,5748,3,Strikeable,6350,7097,7923,747,1573,17162,76200,95076
Insurance Examiner,5748,4,Strikeable,6664,7436,8314,772,1650,17936,79968,99768
Insurance Examiner,5748,5,Strikeable,6982,7803,8713,821,1731,18721,83784,104556
Insurance Examiner,5748,6,Strikeable,7327,8177,9143,850,1816,19571,87924,109716
Insurance Examiner,5748,7,Strikeable,7678,8581,9589,903,1911,20437,92136,115068
Insurance Examiner,5748,8,Strikeable,8057,8999,10065,942,2008,21372,96684,120780
Insurance Examiner,5748,9,Strikeable,8450,9447,10065,997,1615,22341,101400,120780
Insurance Examiner,5748,10,Strikeable,8870,9447,10065,577,1195,23377,106440,120780
Insurance Examiner Entry,5747,1,Strikeable,4776,5345,5964,569,1188,13280,57312,71568
Insurance Examiner Entry,5747,2,Strikeable,5019,5598,6245,579,1226,13879,60228,74940
Insurance Examiner Entry,5747,3,Strikeable,5256,5861,6549,605,1293,14464,63072,78588
Insurance Examiner Entry,5747,4,Strikeable,5503,6146,6866,643,1363,15073,66036,82392
Insurance Examiner Entry,5747,5,Strikeable,5771,6444,7206,673,1435,15734,69252,86472
Insurance Examiner Entry,5747,6,Strikeable,6051,6763,7562,712,1511,16424,72612,90744
Insurance Examiner Entry,5747,7,Strikeable,6350,7097,7923,747,1573,17162,76200,95076
Insurance Examiner Entry,5747,8,Strikeable,6664,7436,8314,772,1650,17936,79968,99768
Insurance Examiner Entry,5747,9,Strikeable,6982,7803,8314,821,1332,18721,83784,99768
Insurance Examiner Entry,5747,10,Strikeable,7327,7803,8314,476,987,19571,87924,99768
Investigator 1,5331,1,Strikeable,3483,4036,4498,553,1015,10091,41796,53976
Investigator 1,5331,2,Strikeable,3629,4036,4498,407,869,10451,43548,53976
Investigator 1,5331,3,Strikeable,3790,4222,4715,432,925,10848,45480,56580
Investigator 1,5331,4,Strikeable,3964,4425,4943,461,979,11277,47568,59316
Investigator 1,5331,5,Strikeable,4155,4639,5169,484,1014,11748,49860,62028
Investigator 1,5331,6,Strikeable,4356,4851,5420,495,1064,12244,52272,65040
Investigator 1,5331,7,Strikeable,4555,5086,5695,531,1140,12735,54660,68340
Investigator 1,5331,8,Strikeable,4776,5345,5964,569,1188,13280,57312,71568
Investigator 1,5331,9,Strikeable,5019,5598,5964,579,945,13879,60228,71568
Investigator 1,5331,10,Strikeable,5256,5598,5964,342,708,14464,63072,71568
Investigator 2,5333,1,Strikeable,4155,4639,5169,484,1014,11748,49860,62028
Investigator 2,5333,2,Strikeable,4356,4851,5420,495,1064,12244,52272,65040
Investigator 2,5333,3,Strikeable,4555,5086,5695,531,1140,12735,54660,68340
Investigator 2,5333,4,Strikeable,4776,5345,5964,569,1188,13280,57312,71568
Investigator 2,5333,5,Strikeable,5019,5598,6245,579,1226,13879,60228,74940
Investigator 2,5333,6,Strikeable,5256,5861,6549,605,1293,14464,63072,78588
Investigator 2,5333,7,Strikeable,5503,6146,6866,643,1363,15073,66036,82392
Investigator 2,5333,8,Strikeable,5771,6444,7206,673,1435,15734,69252,86472
Investigator 2,5333,9,Strikeable,6051,6763,7206,712,1155,16424,72612,86472
Investigator 2,5333,10,Strikeable,6350,6763,7206,413,856,17162,76200,86472
Investigator 3,5333,1,Strikeable,4776,5345,5964,569,1188,13280,57312,71568
Investigator 3,5333,2,Strikeable,5019,5598,6245,579,1226,13879,60228,74940
Investigator 3,5333,3,Strikeable,5256,5861,6549,605,1293,14464,63072,78588
Investigator 3,5333,4,Strikeable,5503,6146,6866,643,1363,15073,66036,82392
Investigator 3,5333,5,Strikeable,5771,6444,7206,673,1435,15734,69252,86472
Investigator 3,5333,6,Strikeable,6051,6763,7562,712,1511,16424,72612,90744
Investigator 3,5333,7,Strikeable,6350,7097,7923,747,1573,17162,76200,95076
Investigator 3,5333,8,Strikeable,6664,7436,8314,772,1650,17936,79968,99768
Investigator 3,5333,9,Strikeable,6982,7803,8314,821,1332,18721,83784,99768
Investigator 3,5333,10,Strikeable,7327,7803,8314,476,987,19571,87924,99768
Investment Analyst 1,1333,1,Strikeable,5019,5598,6245,579,1226,13879,60228,74940
Investment Analyst 1,1333,2,Strikeable,5256,5861,6549,605,1293,14464,63072,78588
Investment Analyst 1,1333,3,Strikeable,5503,6146,6866,643,1363,15073,66036,82392
Investment Analyst 1,1333,4,Strikeable,5771,6444,7206,673,1435,15734,69252,86472
Investment Analyst 1,1333,5,Strikeable,6051,6763,7562,712,1511,16424,72612,90744
Investment Analyst 1,1333,6,Strikeable,6350,7097,7923,747,1573,17162,76200,95076
Investment Analyst 1,1333,7,Strikeable,6664,7436,8314,772,1650,17936,79968,99768
Investment Analyst 1,1333,8,Strikeable,6982,7803,8713,821,1731,18721,83784,104556
Investment Analyst 1,1333,9,Strikeable,7327,8177,8713,850,1386,19571,87924,104556
Investment Analyst 1,1333,10,Strikeable,7678,8177,8713,499,1035,20437,92136,104556
Investment Analyst 2,1333,1,Strikeable,5771,6444,7206,673,1435,15734,69252,86472
Investment Analyst 2,1333,2,Strikeable,6051,6763,7562,712,1511,16424,72612,90744
Investment Analyst 2,1333,3,Strikeable,6350,7097,7923,747,1573,17162,76200,95076
Investment Analyst 2,1333,4,Strikeable,6664,7436,8314,772,1650,17936,79968,99768
Investment Analyst 2,1333,5,Strikeable,6982,7803,8713,821,1731,18721,83784,104556
Investment Analyst 2,1333,6,Strikeable,7327,8177,9143,850,1816,19571,87924,109716
Investment Analyst 2,1333,7,Strikeable,7678,8581,9589,903,1911,20437,92136,115068
Investment Analyst 2,1333,8,Strikeable,8057,8999,10065,942,2008,21372,96684,120780
Investment Analyst 2,1333,9,Strikeable,8450,9447,10065,997,1615,22341,101400,120780
Investment Analyst 2,1333,10,Strikeable,8870,9447,10065,577,1195,23377,106440,120780
Investment Analyst 3,1334,1,Strikeable,6664,7436,8314,772,1650,17936,79968,99768
Investment Analyst 3,1334,2,Strikeable,6982,7803,8713,821,1731,18721,83784,104556
Investment Analyst 3,1334,3,Strikeable,7327,8177,9143,850,1816,19571,87924,109716
Investment Analyst 3,1334,4,Strikeable,7678,8581,9589,903,1911,20437,92136,115068
Investment Analyst 3,1334,5,Strikeable,8057,8999,10065,942,2008,21372,96684,120780
Investment Analyst 3,1334,6,Strikeable,8450,9447,10545,997,2095,22341,101400,126540
Investment Analyst 3,1334,7,Strikeable,8870,9897,11065,1027,2195,23377,106440,132780
Investment Analyst 3,1334,8,Strikeable,9293,10385,11622,1092,2329,24420,111516,139464
Investment Analyst 3,1334,9,Strikeable,9751,10908,11622,1157,1871,25550,117012,139464
Investment Analyst 3,1334,10,Strikeable,10242,10908,11622,666,1380,26761,122904,139464
Juvenile Probation/Social Services Officer/Juvenile Correction Counselor,6633,1,Strikeable,4356,4851,5420,495,1064,12244,52272,65040
Juvenile Probation/Social Services Officer/Juvenile Correction Counselor,6633,2,Strikeable,4555,5086,5695,531,1140,12735,54660,68340
Juvenile Probation/Social Services Officer/Juvenile Correction Counselor,6633,3,Strikeable,4776,5345,5964,569,1188,13280,57312,71568
Juvenile Probation/Social Services Officer/Juvenile Correction Counselor,6633,4,Strikeable,5019,5598,6245,579,1226,13879,60228,74940
Juvenile Probation/Social Services Officer/Juvenile Correction Counselor,6633,5,Strikeable,5256,5861,6549,605,1293,14464,63072,78588
Juvenile Probation/Social Services Officer/Juvenile Correction Counselor,6633,6,Strikeable,5503,6146,6866,643,1363,15073,66036,82392
Juvenile Probation/Social Services Officer/Juvenile Correction Counselor,6633,7,Strikeable,5771,6444,7206,673,1435,15734,69252,86472
Juvenile Probation/Social Services Officer/Juvenile Correction Counselor,6633,8,Strikeable,6051,6763,7562,712,1511,16424,72612,90744
Juvenile Probation/Social Services Officer/Juvenile Correction Counselor,6633,9,Strikeable,6350,7097,7562,747,1212,17162,76200,90744
Juvenile Probation/Social Services Officer/Juvenile Correction Counselor,6633,10,Strikeable,6664,7097,7562,433,898,17936,79968,90744
Laboratory Technician 2,6811,1,Strikeable,3218,3709,4118,491,900,9437,38616,49416
Laboratory Technician 2,6811,2,Strikeable,3335,3709,4118,374,783,9726,40020,49416
Laboratory Technician 2,6811,3,Strikeable,3483,3865,4301,382,818,10091,41796,51612
Laboratory Technician 2,6811,4,Strikeable,3629,4036,4498,407,869,10451,43548,53976
Laboratory Technician 2,6811,5,Strikeable,3790,4222,4715,432,925,10848,45480,56580
Laboratory Technician 2,6811,6,Strikeable,3964,4425,4943,461,979,11277,47568,59316
Laboratory Technician 2,6811,7,Strikeable,4155,4639,5169,484,1014,11748,49860,62028
Laboratory Technician 2,6811,8,Strikeable,4356,4851,5420,495,1064,12244,52272,65040
Laboratory Technician 2,6811,9,Strikeable,4555,5086,5420,531,865,12735,54660,65040
Laboratory Technician 2,6811,10,Strikeable,4776,5086,5420,310,644,13280,57312,65040
Laborer/Student Worker,4116,1,Strikeable,0,,,,,1500,0,
Laborer/Student Worker,4116,2,Strikeable,0,,,,,1500,0,
Laborer/Student Worker,4116,3,Strikeable,0,,,,,1500,0,
Laborer/Student Worker,4116,4,Strikeable,3005,3427,3784,422,779,8912,36060,45408
Laborer/Student Worker,4116,5,Strikeable,3095,3427,3784,332,689,9134,37140,45408
Laborer/Student Worker,4116,6,Strikeable,3218,3552,3952,334,734,9437,38616,47424
Laborer/Student Worker,4116,7,Strikeable,3335,3709,4118,374,783,9726,40020,49416
Laborer/Student Worker,4116,8,Strikeable,3483,3865,4301,382,818,10091,41796,51612
Laborer/Student Worker,4116,9,Strikeable,3629,4036,4301,407,672,10451,43548,51612
Laborer/Student Worker,4116,10,Strikeable,3790,4036,4301,246,511,10848,45480,51612
Legal Secretary,110,1,Strikeable,3335,3865,4301,530,966,9726,40020,51612
Legal Secretary,110,2,Strikeable,3483,3865,4301,382,818,10091,41796,51612
Legal Secretary,110,3,Strikeable,3629,4036,4498,407,869,10451,43548,53976
Legal Secretary,110,4,Strikeable,3790,4222,4715,432,925,10848,45480,56580
Legal Secretary,110,5,Strikeable,3964,4425,4943,461,979,11277,47568,59316
Legal Secretary,110,6,Strikeable,4155,4639,5169,484,1014,11748,49860,62028
Legal Secretary,110,7,Strikeable,4356,4851,5420,495,1064,12244,52272,65040
Legal Secretary,110,8,Strikeable,4555,5086,5695,531,1140,12735,54660,68340
Legal Secretary,110,9,Strikeable,4776,5345,5695,569,919,13280,57312,68340
Legal Secretary,110,10,Strikeable,5019,5345,5695,326,676,13879,60228,68340
Librarian,3330,1,Strikeable,4776,5345,5964,569,1188,13280,57312,71568
Librarian,3330,2,Strikeable,5019,5598,6245,579,1226,13879,60228,74940
Librarian,3330,3,Strikeable,5256,5861,6549,605,1293,14464,63072,78588
Librarian,3330,4,Strikeable,5503,6146,6866,643,1363,15073,66036,82392
Librarian,3330,5,Strikeable,5771,6444,7206,673,1435,15734,69252,86472
Librarian,3330,6,Strikeable,6051,6763,7562,712,1511,16424,72612,90744
Librarian,3330,7,Strikeable,6350,7097,7923,747,1573,17162,76200,95076
Librarian,3330,8,Strikeable,6664,7436,8314,772,1650,17936,79968,99768
Librarian,3330,9,Strikeable,6982,7803,8314,821,1332,18721,83784,99768
Librarian,3330,10,Strikeable,7327,7803,8314,476,987,19571,87924,99768
Licensed Practical Nurse,6135,1,Strikeable,4131,4621,5172,490,1041,11689,49572,62064
Licensed Practical Nurse,6135,2,Strikeable,4339,4854,5399,515,1060,12202,52068,64788
Licensed Practical Nurse,6135,3,Strikeable,4558,5067,5653,509,1095,12742,54696,67836
Licensed Practical Nurse,6135,4,Strikeable,4758,5306,5959,548,1201,13235,57096,71508
Licensed Practical Nurse,6135,5,Strikeable,4982,5592,6233,610,1251,13788,59784,74796
Licensed Practical Nurse,6135,6,Strikeable,5251,5850,6504,599,1253,14451,63012,78048
Licensed Practical Nurse,6135,7,Strikeable,5493,6105,6819,612,1326,15048,65916,81828
Licensed Practical Nurse,6135,8,Strikeable,5732,6400,7147,668,1415,15638,68784,85764
Licensed Practical Nurse,6135,9,Strikeable,6009,6707,7147,698,1138,16321,72108,85764
Licensed Practical Nurse,6135,10,Strikeable,6298,6707,7147,409,849,17034,75576,85764
Livestock Brand Inspector,5430,1,Strikeable,3005,3427,3784,422,779,8912,36060,45408
Livestock Brand Inspector,5430,2,Strikeable,3095,3427,3784,332,689,9134,37140,45408
Livestock Brand Inspector,5430,3,Strikeable,3218,3552,3952,334,734,9437,38616,47424
Livestock Brand Inspector,5430,4,Strikeable,3335,3709,4118,374,783,9726,40020,49416
Livestock Brand Inspector,5430,5,Strikeable,3483,3865,4301,382,818,10091,41796,51612
Livestock Brand Inspector,5430,6,Strikeable,3629,4036,4498,407,869,10451,43548,53976
Livestock Brand Inspector,5430,7,Strikeable,3790,4222,4715,432,925,10848,45480,56580
Livestock Brand Inspector,5430,8,Strikeable,3964,4425,4943,461,979,11277,47568,59316
Livestock Brand Inspector,5430,9,Strikeable,4155,4639,4943,484,788,11748,49860,59316
Livestock Brand Inspector,5430,10,Strikeable,4356,4639,4943,283,587,12244,52272,59316
Loan Specialist 1,1001,1,Strikeable,4155,4639,5169,484,1014,11748,49860,62028
Loan Specialist 1,1001,2,Strikeable,4356,4851,5420,495,1064,12244,52272,65040
Loan Specialist 1,1001,3,Strikeable,4555,5086,5695,531,1140,12735,54660,68340
Loan Specialist 1,1001,4,Strikeable,4776,5345,5964,569,1188,13280,57312,71568
Loan Specialist 1,1001,5,Strikeable,5019,5598,6245,579,1226,13879,60228,74940
Loan Specialist 1,1001,6,Strikeable,5256,5861,6549,605,1293,14464,63072,78588
Loan Specialist 1,1001,7,Strikeable,5503,6146,6866,643,1363,15073,66036,82392
Loan Specialist 1,1001,8,Strikeable,5771,6444,7206,673,1435,15734,69252,86472
Loan Specialist 1,1001,9,Strikeable,6051,6763,7206,712,1155,16424,72612,86472
Loan Specialist 1,1001,10,Strikeable,6350,6763,7206,413,856,17162,76200,86472
Loan Specialist 2,1003,1,Strikeable,5019,5598,6245,579,1226,13879,60228,74940
Loan Specialist 2,1003,2,Strikeable,5256,5861,6549,605,1293,14464,63072,78588
Loan Specialist 2,1003,3,Strikeable,5503,6146,6866,643,1363,15073,66036,82392
Loan Specialist 2,1003,4,Strikeable,5771,6444,7206,673,1435,15734,69252,86472
Loan Specialist 2,1003,5,Strikeable,6051,6763,7562,712,1511,16424,72612,90744
Loan Specialist 2,1003,6,Strikeable,6350,7097,7923,747,1573,17162,76200,95076
Loan Specialist 2,1003,7,Strikeable,6664,7436,8314,772,1650,17936,79968,99768
Loan Specialist 2,1003,8,Strikeable,6982,7803,8713,821,1731,18721,83784,104556
Loan Specialist 2,1003,9,Strikeable,7327,8177,8713,850,1386,19571,87924,104556
Loan Specialist 2,1003,10,Strikeable,7678,8177,8713,499,1035,20437,92136,104556
Loan Specialist 3,1003,1,Strikeable,5771,6444,7206,673,1435,15734,69252,86472
Loan Specialist 3,1003,2,Strikeable,6051,6763,7562,712,1511,16424,72612,90744
Loan Specialist 3,1003,3,Strikeable,6350,7097,7923,747,1573,17162,76200,95076
Loan Specialist 3,1003,4,Strikeable,6664,7436,8314,772,1650,17936,79968,99768
Loan Specialist 3,1003,5,Strikeable,6982,7803,8713,821,1731,18721,83784,104556
Loan Specialist 3,1003,6,Strikeable,7327,8177,9143,850,1816,19571,87924,109716
Loan Specialist 3,1003,7,Strikeable,7678,8581,9589,903,1911,20437,92136,115068
Loan Specialist 3,1003,8,Strikeable,8057,8999,10065,942,2008,21372,96684,120780
Loan Specialist 3,1003,9,Strikeable,8450,9447,10065,997,1615,22341,101400,120780
Loan Specialist 3,1003,10,Strikeable,8870,9447,10065,577,1195,23377,106440,120780
Machinist,4018,1,Strikeable,4776,5345,5964,569,1188,13280,57312,71568
Machinist,4018,2,Strikeable,5019,5598,6245,579,1226,13879,60228,74940
Machinist,4018,3,Strikeable,5256,5861,6549,605,1293,14464,63072,78588
Machinist,4018,4,Strikeable,5503,6146,6866,643,1363,15073,66036,82392
Machinist,4018,5,Strikeable,5771,6444,7206,673,1435,15734,69252,86472
Machinist,4018,6,Strikeable,6051,6763,7562,712,1511,16424,72612,90744
Machinist,4018,7,Strikeable,6350,7097,7923,747,1573,17162,76200,95076
Machinist,4018,8,Strikeable,6664,7436,8314,772,1650,17936,79968,99768
Machinist,4018,9,Strikeable,6982,7803,8314,821,1332,18721,83784,99768
Machinist,4018,10,Strikeable,7327,7803,8314,476,987,19571,87924,99768
Mail Delivery Driver,4404,1,Strikeable,3005,3427,3784,422,779,8912,36060,45408
Mail Delivery Driver,4404,2,Strikeable,3095,3427,3784,332,689,9134,37140,45408
Mail Delivery Driver,4404,3,Strikeable,3218,3552,3952,334,734,9437,38616,47424
Mail Delivery Driver,4404,4,Strikeable,3335,3709,4118,374,783,9726,40020,49416
Mail Delivery Driver,4404,5,Strikeable,3483,3865,4301,382,818,10091,41796,51612
Mail Delivery Driver,4404,6,Strikeable,3629,4036,4498,407,869,10451,43548,53976
Mail Delivery Driver,4404,7,Strikeable,3790,4222,4715,432,925,10848,45480,56580
Mail Delivery Driver,4404,8,Strikeable,3964,4425,4943,461,979,11277,47568,59316
Mail Delivery Driver,4404,9,Strikeable,4155,4639,4943,484,788,11748,49860,59316
Mail Delivery Driver,4404,10,Strikeable,4356,4639,4943,283,587,12244,52272,59316
Mail Equipment Operator 1,403,1,Strikeable,0,,,,,1500,0,
Mail Equipment Operator 1,403,2,Strikeable,0,,,,,1500,0,
Mail Equipment Operator 1,403,3,Strikeable,0,,,,,1500,0,
Mail Equipment Operator 1,403,4,Strikeable,3005,3427,3784,422,779,8912,36060,45408
Mail Equipment Operator 1,403,5,Strikeable,3095,3427,3784,332,689,9134,37140,45408
Mail Equipment Operator 1,403,6,Strikeable,3218,3552,3952,334,734,9437,38616,47424
Mail Equipment Operator 1,403,7,Strikeable,3335,3709,4118,374,783,9726,40020,49416
Mail Equipment Operator 1,403,8,Strikeable,3483,3865,4301,382,818,10091,41796,51612
Mail Equipment Operator 1,403,9,Strikeable,3629,4036,4301,407,672,10451,43548,51612
Mail Equipment Operator 1,403,10,Strikeable,3790,4036,4301,246,511,10848,45480,51612
Mail Equipment Operator 2,404,1,Strikeable,3005,3427,3784,422,779,8912,36060,45408
Mail Equipment Operator 2,404,2,Strikeable,3095,3427,3784,332,689,9134,37140,45408
Mail Equipment Operator 2,404,3,Strikeable,3218,3552,3952,334,734,9437,38616,47424
Mail Equipment Operator 2,404,4,Strikeable,3335,3709,4118,374,783,9726,40020,49416
Mail Equipment Operator 2,404,5,Strikeable,3483,3865,4301,382,818,10091,41796,51612
Mail Equipment Operator 2,404,6,Strikeable,3629,4036,4498,407,869,10451,43548,53976
Mail Equipment Operator 2,404,7,Strikeable,3790,4222,4715,432,925,10848,45480,56580
Mail Equipment Operator 2,404,8,Strikeable,3964,4425,4943,461,979,11277,47568,59316
Mail Equipment Operator 2,404,9,Strikeable,4155,4639,4943,484,788,11748,49860,59316
Mail Equipment Operator 2,404,10,Strikeable,4356,4639,4943,283,587,12244,52272,59316
Mail Services Assistant,405,1,Strikeable,0,,,,,1500,0,
Mail Services Assistant,405,2,Strikeable,0,,,,,1500,0,
Mail Services Assistant,405,3,Strikeable,3005,3427,3784,422,779,8912,36060,45408
Mail Services Assistant,405,4,Strikeable,3095,3427,3784,332,689,9134,37140,45408
Mail Services Assistant,405,5,Strikeable,3218,3552,3952,334,734,9437,38616,47424
Mail Services Assistant,405,6,Strikeable,3335,3709,4118,374,783,9726,40020,49416
Mail Services Assistant,405,7,Strikeable,3483,3865,4301,382,818,10091,41796,51612
Mail Services Assistant,405,8,Strikeable,3629,4036,4498,407,869,10451,43548,53976
Mail Services Assistant,405,9,Strikeable,3790,4222,4498,432,708,10848,45480,53976
Mail Services Assistant,405,10,Strikeable,3964,4222,4498,258,534,11277,47568,53976
Manual Arts Instructor,3304,1,Strikeable,3218,3552,3952,334,734,9437,38616,47424
Manual Arts Instructor,3304,2,Strikeable,3335,3709,4118,374,783,9726,40020,49416
Manual Arts Instructor,3304,3,Strikeable,3483,3865,4301,382,818,10091,41796,51612
Manual Arts Instructor,3304,4,Strikeable,3629,4036,4498,407,869,10451,43548,53976
Manual Arts Instructor,3304,5,Strikeable,3790,4222,4715,432,925,10848,45480,56580
Manual Arts Instructor,3304,6,Strikeable,3964,4425,4943,461,979,11277,47568,59316
Manual Arts Instructor,3304,7,Strikeable,4155,4639,5169,484,1014,11748,49860,62028
Manual Arts Instructor,3304,8,Strikeable,4356,4851,5420,495,1064,12244,52272,65040
Manual Arts Instructor,3304,9,Strikeable,4555,5086,5420,531,865,12735,54660,65040
Manual Arts Instructor,3304,10,Strikeable,4776,5086,5420,310,644,13280,57312,65040
Medical Consultant,7538,1,Strikeable,8870,9897,11065,1027,2195,23377,106440,132780
Medical Consultant,7538,2,Strikeable,9293,10385,11622,1092,2329,24420,111516,139464
Medical Consultant,7538,3,Strikeable,9751,10908,12187,1157,2436,25550,117012,146244
Medical Consultant,7538,4,Strikeable,10242,11438,12785,1196,2543,26761,122904,153420
Medical Consultant,7538,5,Strikeable,10740,11999,13419,1259,2679,27989,128880,161028
Medical Consultant,7538,6,Strikeable,11267,12594,14080,1327,2813,29289,135204,168960
Medical Consultant,7538,7,Strikeable,11825,13215,14775,1390,2950,30665,141900,177300
Medical Consultant,7538,8,Strikeable,12408,13866,15503,1458,3095,32103,148896,186036
Medical Consultant,7538,9,Strikeable,13020,14550,15503,1530,2483,33613,156240,186036
Medical Consultant,7538,10,Strikeable,13662,14550,15503,888,1841,35196,163944,186036
Medical Laboratory Technician 1,6830,1,Strikeable,3335,3865,4301,530,966,9726,40020,51612
Medical Laboratory Technician 1,6830,2,Strikeable,3483,3865,4301,382,818,10091,41796,51612
Medical Laboratory Technician 1,6830,3,Strikeable,3629,4036,4498,407,869,10451,43548,53976
Medical Laboratory Technician 1,6830,4,Strikeable,3790,4222,4715,432,925,10848,45480,56580
Medical Laboratory Technician 1,6830,5,Strikeable,3964,4425,4943,461,979,11277,47568,59316
Medical Laboratory Technician 1,6830,6,Strikeable,4155,4639,5169,484,1014,11748,49860,62028
Medical Laboratory Technician 1,6830,7,Strikeable,4356,4851,5420,495,1064,12244,52272,65040
Medical Laboratory Technician 1,6830,8,Strikeable,4555,5086,5695,531,1140,12735,54660,68340
Medical Laboratory Technician 1,6830,9,Strikeable,4776,5345,5695,569,919,13280,57312,68340
Medical Laboratory Technician 1,6830,10,Strikeable,5019,5345,5695,326,676,13879,60228,68340
Medical Laboratory Technician 2,6831,1,Strikeable,3629,4222,4715,593,1086,10451,43548,56580
Medical Laboratory Technician 2,6831,2,Strikeable,3790,4222,4715,432,925,10848,45480,56580
Medical Laboratory Technician 2,6831,3,Strikeable,3964,4425,4943,461,979,11277,47568,59316
Medical Laboratory Technician 2,6831,4,Strikeable,4155,4639,5169,484,1014,11748,49860,62028
Medical Laboratory Technician 2,6831,5,Strikeable,4356,4851,5420,495,1064,12244,52272,65040
Medical Laboratory Technician 2,6831,6,Strikeable,4555,5086,5695,531,1140,12735,54660,68340
Medical Laboratory Technician 2,6831,7,Strikeable,4776,5345,5964,569,1188,13280,57312,71568
Medical Laboratory Technician 2,6831,8,Strikeable,5019,5598,6245,579,1226,13879,60228,74940
Medical Laboratory Technician 2,6831,9,Strikeable,5256,5861,6245,605,989,14464,63072,74940
Medical Laboratory Technician 2,6831,10,Strikeable,5503,5861,6245,358,742,15073,66036,74940
Medical Review Coordinator,6310,1,Strikeable,6756,7534,8409,778,1653,18163,81072,100908
Medical Review Coordinator,6310,2,Strikeable,7074,7892,8810,818,1736,18947,84888,105720
Medical Review Coordinator,6310,3,Strikeable,7410,8269,9226,859,1816,19776,88920,110712
Medical Review Coordinator,6310,4,Strikeable,7764,8658,9667,894,1903,20649,93168,116004
Medical Review Coordinator,6310,5,Strikeable,8130,9073,10172,943,2042,21552,97560,122064
Medical Review Coordinator,6310,6,Strikeable,8519,9547,10604,1028,2085,22511,102228,127248
Medical Review Coordinator,6310,7,Strikeable,8964,9952,11108,988,2144,23609,107568,133296
Medical Review Coordinator,6310,8,Strikeable,9345,10425,11636,1080,2291,24549,112140,139632
Medical Review Coordinator,6310,9,Strikeable,9789,10921,11636,1132,1847,25644,117468,139632
Medical Review Coordinator,6310,10,Strikeable,10254,10921,11636,667,1382,26791,123048,139632
Mental Health Security Technician,6708,1,Strikeable,3218,3865,4301,647,1083,9437,38616,51612
Mental Health Security Technician,6708,2,Strikeable,3335,3865,4301,530,966,9726,40020,51612
Mental Health Security Technician,6708,3,Strikeable,3483,3865,4301,382,818,10091,41796,51612
Mental Health Security Technician,6708,4,Strikeable,3629,4036,4498,407,869,10451,43548,53976
Mental Health Security Technician,6708,5,Strikeable,3790,4222,4715,432,925,10848,45480,56580
Mental Health Security Technician,6708,6,Strikeable,3964,4425,4943,461,979,11277,47568,59316
Mental Health Security Technician,6708,7,Strikeable,4155,4639,5169,484,1014,11748,49860,62028
Mental Health Security Technician,6708,8,Strikeable,4356,4851,5420,495,1064,12244,52272,65040
Mental Health Security Technician,6708,9,Strikeable,4555,5086,5420,531,865,12735,54660,65040
Mental Health Security Technician,6708,10,Strikeable,4776,5086,5420,310,644,13280,57312,65040
Mental Health Therapist 1,6711,1,Strikeable,3218,3865,4301,647,1083,9437,38616,51612
Mental Health Therapist 1,6711,2,Strikeable,3335,3865,4301,530,966,9726,40020,51612
Mental Health Therapist 1,6711,3,Strikeable,3483,3865,4301,382,818,10091,41796,51612
Mental Health Therapist 1,6711,4,Strikeable,3629,4036,4498,407,869,10451,43548,53976
Mental Health Therapist 1,6711,5,Strikeable,3790,4222,4715,432,925,10848,45480,56580
Mental Health Therapist 1,6711,6,Strikeable,3964,4425,4943,461,979,11277,47568,59316
Mental Health Therapist 1,6711,7,Strikeable,4155,4639,5169,484,1014,11748,49860,62028
Mental Health Therapist 1,6711,8,Strikeable,4356,4851,5420,495,1064,12244,52272,65040
Mental Health Therapist 1,6711,9,Strikeable,4555,5086,5420,531,865,12735,54660,65040
Mental Health Therapist 1,6711,10,Strikeable,4776,5086,5420,310,644,13280,57312,65040
Mental Health Therapist 2,6713,1,Strikeable,3483,4222,4715,739,1232,10091,41796,56580
Mental Health Therapist 2,6713,2,Strikeable,3629,4222,4715,593,1086,10451,43548,56580
Mental Health Therapist 2,6713,3,Strikeable,3790,4222,4715,432,925,10848,45480,56580
Mental Health Therapist 2,6713,4,Strikeable,3964,4425,4943,461,979,11277,47568,59316
Mental Health Therapist 2,6713,5,Strikeable,4155,4639,5169,484,1014,11748,49860,62028
Mental Health Therapist 2,6713,6,Strikeable,4356,4851,5420,495,1064,12244,52272,65040
Mental Health Therapist 2,6713,7,Strikeable,4555,5086,5695,531,1140,12735,54660,68340
Mental Health Therapist 2,6713,8,Strikeable,4776,5345,5964,569,1188,13280,57312,71568
Mental Health Therapist 2,6713,9,Strikeable,5019,5598,5964,579,945,13879,60228,71568
Mental Health Therapist 2,6713,10,Strikeable,5256,5598,5964,342,708,14464,63072,71568
Mental Health Therapy Coordinator,6718,1,Strikeable,3483,4222,4715,739,1232,10091,41796,56580
Mental Health Therapy Coordinator,6718,2,Strikeable,3629,4222,4715,593,1086,10451,43548,56580
Mental Health Therapy Coordinator,6718,3,Strikeable,3790,4222,4715,432,925,10848,45480,56580
Mental Health Therapy Coordinator,6718,4,Strikeable,3964,4425,4943,461,979,11277,47568,59316
Mental Health Therapy Coordinator,6718,5,Strikeable,4155,4639,5169,484,1014,11748,49860,62028
Mental Health Therapy Coordinator,6718,6,Strikeable,4356,4851,5420,495,1064,12244,52272,65040
Mental Health Therapy Coordinator,6718,7,Strikeable,4555,5086,5695,531,1140,12735,54660,68340
Mental Health Therapy Coordinator,6718,8,Strikeable,4776,5345,5964,569,1188,13280,57312,71568
Mental Health Therapy Coordinator,6718,9,Strikeable,5019,5598,5964,579,945,13879,60228,71568
Mental Health Therapy Coordinator,6718,10,Strikeable,5256,5598,5964,342,708,14464,63072,71568
Mental Health Therapy Technician,6710,1,Strikeable,3005,3552,3952,547,947,8912,36060,47424
Mental Health Therapy Technician,6710,2,Strikeable,3095,3552,3952,457,857,9134,37140,47424
Mental Health Therapy Technician,6710,3,Strikeable,3218,3552,3952,334,734,9437,38616,47424
Mental Health Therapy Technician,6710,4,Strikeable,3335,3709,4118,374,783,9726,40020,49416
Mental Health Therapy Technician,6710,5,Strikeable,3483,3865,4301,382,818,10091,41796,51612
Mental Health Therapy Technician,6710,6,Strikeable,3629,4036,4498,407,869,10451,43548,53976
Mental Health Therapy Technician,6710,7,Strikeable,3790,4222,4715,432,925,10848,45480,56580
Mental Health Therapy Technician,6710,8,Strikeable,3964,4425,4943,461,979,11277,47568,59316
Mental Health Therapy Technician,6710,9,Strikeable,4155,4639,4943,484,788,11748,49860,59316
Mental Health Therapy Technician,6710,10,Strikeable,4356,4639,4943,283,587,12244,52272,59316
Microbiologist 1,3779,1,Strikeable,4155,4639,5169,484,1014,11748,49860,62028
Microbiologist 1,3779,2,Strikeable,4356,4851,5420,495,1064,12244,52272,65040
Microbiologist 1,3779,3,Strikeable,4555,5086,5695,531,1140,12735,54660,68340
Microbiologist 1,3779,4,Strikeable,4776,5345,5964,569,1188,13280,57312,71568
Microbiologist 1,3779,5,Strikeable,5019,5598,6245,579,1226,13879,60228,74940
Microbiologist 1,3779,6,Strikeable,5256,5861,6549,605,1293,14464,63072,78588
Microbiologist 1,3779,7,Strikeable,5503,6146,6866,643,1363,15073,66036,82392
Microbiologist 1,3779,8,Strikeable,5771,6444,7206,673,1435,15734,69252,86472
Microbiologist 1,3779,9,Strikeable,6051,6763,7206,712,1155,16424,72612,86472
Microbiologist 1,3779,10,Strikeable,6350,6763,7206,413,856,17162,76200,86472
Microbiologist 2,3780,1,Strikeable,4555,5086,5695,531,1140,12735,54660,68340
Microbiologist 2,3780,2,Strikeable,4776,5345,5964,569,1188,13280,57312,71568
Microbiologist 2,3780,3,Strikeable,5019,5598,6245,579,1226,13879,60228,74940
Microbiologist 2,3780,4,Strikeable,5256,5861,6549,605,1293,14464,63072,78588
Microbiologist 2,3780,5,Strikeable,5503,6146,6866,643,1363,15073,66036,82392
Microbiologist 2,3780,6,Strikeable,5771,6444,7206,673,1435,15734,69252,86472
Microbiologist 2,3780,7,Strikeable,6051,6763,7562,712,1511,16424,72612,90744
Microbiologist 2,3780,8,Strikeable,6350,7097,7923,747,1573,17162,76200,95076
Microbiologist 2,3780,9,Strikeable,6664,7436,7923,772,1259,17936,79968,95076
Microbiologist 2,3780,10,Strikeable,6982,7436,7923,454,941,18721,83784,95076
Microbiologist 3,3781,1,Strikeable,5256,5861,6549,605,1293,14464,63072,78588
Microbiologist 3,3781,2,Strikeable,5503,6146,6866,643,1363,15073,66036,82392
Microbiologist 3,3781,3,Strikeable,5771,6444,7206,673,1435,15734,69252,86472
Microbiologist 3,3781,4,Strikeable,6051,6763,7562,712,1511,16424,72612,90744
Microbiologist 3,3781,5,Strikeable,6350,7097,7923,747,1573,17162,76200,95076
Microbiologist 3,3781,6,Strikeable,6664,7436,8314,772,1650,17936,79968,99768
Microbiologist 3,3781,7,Strikeable,6982,7803,8713,821,1731,18721,83784,104556
Microbiologist 3,3781,8,Strikeable,7327,8177,9143,850,1816,19571,87924,109716
Microbiologist 3,3781,9,Strikeable,7678,8581,9143,903,1465,20437,92136,109716
Microbiologist 3,3781,10,Strikeable,8057,8581,9143,524,1086,21372,96684,109716
Motor Carrier Enforcement Officer 1,5857,1,Strikeable,3790,4425,4943,635,1153,10848,45480,59316
Motor Carrier Enforcement Officer 1,5857,2,Strikeable,3964,4425,4943,461,979,11277,47568,59316
Motor Carrier Enforcement Officer 1,5857,3,Strikeable,4155,4639,5169,484,1014,11748,49860,62028
Motor Carrier Enforcement Officer 1,5857,4,Strikeable,4356,4851,5420,495,1064,12244,52272,65040
Motor Carrier Enforcement Officer 1,5857,5,Strikeable,4555,5086,5695,531,1140,12735,54660,68340
Motor Carrier Enforcement Officer 1,5857,6,Strikeable,4776,5345,5964,569,1188,13280,57312,71568
Motor Carrier Enforcement Officer 1,5857,7,Strikeable,5019,5598,6245,579,1226,13879,60228,74940
Motor Carrier Enforcement Officer 1,5857,8,Strikeable,5256,5861,6549,605,1293,14464,63072,78588
Motor Carrier Enforcement Officer 1,5857,9,Strikeable,5503,6146,6549,643,1046,15073,66036,78588
Motor Carrier Enforcement Officer 1,5857,10,Strikeable,5771,6146,6549,375,778,15734,69252,78588
Motor Carrier Enforcement Officer 2,5858,1,Strikeable,4356,4851,5420,495,1064,12244,52272,65040
Motor Carrier Enforcement Officer 2,5858,2,Strikeable,4555,5086,5695,531,1140,12735,54660,68340
Motor Carrier Enforcement Officer 2,5858,3,Strikeable,4776,5345,5964,569,1188,13280,57312,71568
Motor Carrier Enforcement Officer 2,5858,4,Strikeable,5019,5598,6245,579,1226,13879,60228,74940
Motor Carrier Enforcement Officer 2,5858,5,Strikeable,5256,5861,6549,605,1293,14464,63072,78588
Motor Carrier Enforcement Officer 2,5858,6,Strikeable,5503,6146,6866,643,1363,15073,66036,82392
Motor Carrier Enforcement Officer 2,5858,7,Strikeable,5771,6444,7206,673,1435,15734,69252,86472
Motor Carrier Enforcement Officer 2,5858,8,Strikeable,6051,6763,7562,712,1511,16424,72612,90744
Motor Carrier Enforcement Officer 2,5858,9,Strikeable,6350,7097,7562,747,1212,17162,76200,90744
Motor Carrier Enforcement Officer 2,5858,10,Strikeable,6664,7097,7562,433,898,17936,79968,90744
Natural Resource Specialist 1,8501,1,Strikeable,3790,4425,4943,635,1153,10848,45480,59316
Natural Resource Specialist 1,8501,2,Strikeable,3964,4425,4943,461,979,11277,47568,59316
Natural Resource Specialist 1,8501,3,Strikeable,4155,4639,5169,484,1014,11748,49860,62028
Natural Resource Specialist 1,8501,4,Strikeable,4356,4851,5420,495,1064,12244,52272,65040
Natural Resource Specialist 1,8501,5,Strikeable,4555,5086,5695,531,1140,12735,54660,68340
Natural Resource Specialist 1,8501,6,Strikeable,4776,5345,5964,569,1188,13280,57312,71568
Natural Resource Specialist 1,8501,7,Strikeable,5019,5598,6245,579,1226,13879,60228,74940
Natural Resource Specialist 1,8501,8,Strikeable,5256,5861,6549,605,1293,14464,63072,78588
Natural Resource Specialist 1,8501,9,Strikeable,5503,6146,6549,643,1046,15073,66036,78588
Natural Resource Specialist 1,8501,10,Strikeable,5771,6146,6549,375,778,15734,69252,78588
Natural Resource Specialist 2,8503,1,Strikeable,4356,4851,5420,495,1064,12244,52272,65040
Natural Resource Specialist 2,8503,2,Strikeable,4555,5086,5695,531,1140,12735,54660,68340
Natural Resource Specialist 2,8503,3,Strikeable,4776,5345,5964,569,1188,13280,57312,71568
Natural Resource Specialist 2,8503,4,Strikeable,5019,5598,6245,579,1226,13879,60228,74940
Natural Resource Specialist 2,8503,5,Strikeable,5256,5861,6549,605,1293,14464,63072,78588
Natural Resource Specialist 2,8503,6,Strikeable,5503,6146,6866,643,1363,15073,66036,82392
Natural Resource Specialist 2,8503,7,Strikeable,5771,6444,7206,673,1435,15734,69252,86472
Natural Resource Specialist 2,8503,8,Strikeable,6051,6763,7562,712,1511,16424,72612,90744
Natural Resource Specialist 2,8503,9,Strikeable,6350,7097,7562,747,1212,17162,76200,90744
Natural Resource Specialist 2,8503,10,Strikeable,6664,7097,7562,433,898,17936,79968,90744
Natural Resource Specialist 3,8503,1,Strikeable,5019,5598,6245,579,1226,13879,60228,74940
Natural Resource Specialist 3,8503,2,Strikeable,5256,5861,6549,605,1293,14464,63072,78588
Natural Resource Specialist 3,8503,3,Strikeable,5503,6146,6866,643,1363,15073,66036,82392
Natural Resource Specialist 3,8503,4,Strikeable,5771,6444,7206,673,1435,15734,69252,86472
Natural Resource Specialist 3,8503,5,Strikeable,6051,6763,7562,712,1511,16424,72612,90744
Natural Resource Specialist 3,8503,6,Strikeable,6350,7097,7923,747,1573,17162,76200,95076
Natural Resource Specialist 3,8503,7,Strikeable,6664,7436,8314,772,1650,17936,79968,99768
Natural Resource Specialist 3,8503,8,Strikeable,6982,7803,8713,821,1731,18721,83784,104556
Natural Resource Specialist 3,8503,9,Strikeable,7327,8177,8713,850,1386,19571,87924,104556
Natural Resource Specialist 3,8503,10,Strikeable,7678,8177,8713,499,1035,20437,92136,104556
Natural Resource Specialist 4,8504,1,Strikeable,5771,6444,7206,673,1435,15734,69252,86472
Natural Resource Specialist 4,8504,2,Strikeable,6051,6763,7562,712,1511,16424,72612,90744
Natural Resource Specialist 4,8504,3,Strikeable,6350,7097,7923,747,1573,17162,76200,95076
Natural Resource Specialist 4,8504,4,Strikeable,6664,7436,8314,772,1650,17936,79968,99768
Natural Resource Specialist 4,8504,5,Strikeable,6982,7803,8713,821,1731,18721,83784,104556
Natural Resource Specialist 4,8504,6,Strikeable,7327,8177,9143,850,1816,19571,87924,109716
Natural Resource Specialist 4,8504,7,Strikeable,7678,8581,9589,903,1911,20437,92136,115068
Natural Resource Specialist 4,8504,8,Strikeable,8057,8999,10065,942,2008,21372,96684,120780
Natural Resource Specialist 4,8504,9,Strikeable,8450,9447,10065,997,1615,22341,101400,120780
Natural Resource Specialist 4,8504,10,Strikeable,8870,9447,10065,577,1195,23377,106440,120780
Natural Resource Specialist 5,8505,1,Strikeable,6350,7097,7923,747,1573,17162,76200,95076
Natural Resource Specialist 5,8505,2,Strikeable,6664,7436,8314,772,1650,17936,79968,99768
Natural Resource Specialist 5,8505,3,Strikeable,6982,7803,8713,821,1731,18721,83784,104556
Natural Resource Specialist 5,8505,4,Strikeable,7327,8177,9143,850,1816,19571,87924,109716
Natural Resource Specialist 5,8505,5,Strikeable,7678,8581,9589,903,1911,20437,92136,115068
Natural Resource Specialist 5,8505,6,Strikeable,8057,8999,10065,942,2008,21372,96684,120780
Natural Resource Specialist 5,8505,7,Strikeable,8450,9447,10545,997,2095,22341,101400,126540
Natural Resource Specialist 5,8505,8,Strikeable,8870,9897,11065,1027,2195,23377,106440,132780
Natural Resource Specialist 5,8505,9,Strikeable,9293,10385,11065,1092,1772,24420,111516,132780
Natural Resource Specialist 5,8505,10,Strikeable,9751,10385,11065,634,1314,25550,117012,132780
Nutrition Consultant,5955,1,Strikeable,5503,6146,6866,643,1363,15073,66036,82392
Nutrition Consultant,5955,2,Strikeable,5771,6444,7206,673,1435,15734,69252,86472
Nutrition Consultant,5955,3,Strikeable,6051,6763,7562,712,1511,16424,72612,90744
Nutrition Consultant,5955,4,Strikeable,6350,7097,7923,747,1573,17162,76200,95076
Nutrition Consultant,5955,5,Strikeable,6664,7436,8314,772,1650,17936,79968,99768
Nutrition Consultant,5955,6,Strikeable,6982,7803,8713,821,1731,18721,83784,104556
Nutrition Consultant,5955,7,Strikeable,7327,8177,9143,850,1816,19571,87924,109716
Nutrition Consultant,5955,8,Strikeable,7678,8581,9589,903,1911,20437,92136,115068
Nutrition Consultant,5955,9,Strikeable,8057,8999,9589,942,1532,21372,96684,115068
Nutrition Consultant,5955,10,Strikeable,8450,8999,9589,549,1139,22341,101400,115068
Occupational Safety Specialist 1,5709,1,Strikeable,3964,4425,4943,461,979,11277,47568,59316
Occupational Safety Specialist 1,5709,2,Strikeable,4155,4639,5169,484,1014,11748,49860,62028
Occupational Safety Specialist 1,5709,3,Strikeable,4356,4851,5420,495,1064,12244,52272,65040
Occupational Safety Specialist 1,5709,4,Strikeable,4555,5086,5695,531,1140,12735,54660,68340
Occupational Safety Specialist 1,5709,5,Strikeable,4776,5345,5964,569,1188,13280,57312,71568
Occupational Safety Specialist 1,5709,6,Strikeable,5019,5598,6245,579,1226,13879,60228,74940
Occupational Safety Specialist 1,5709,7,Strikeable,5256,5861,6549,605,1293,14464,63072,78588
Occupational Safety Specialist 1,5709,8,Strikeable,5503,6146,6866,643,1363,15073,66036,82392
Occupational Safety Specialist 1,5709,9,Strikeable,5771,6444,6866,673,1095,15734,69252,82392
Occupational Safety Specialist 1,5709,10,Strikeable,6051,6444,6866,393,815,16424,72612,82392
Occupational Safety Specialist 2,5710,1,Strikeable,5019,5598,6245,579,1226,13879,60228,74940
Occupational Safety Specialist 2,5710,2,Strikeable,5256,5861,6549,605,1293,14464,63072,78588
Occupational Safety Specialist 2,5710,3,Strikeable,5503,6146,6866,643,1363,15073,66036,82392
Occupational Safety Specialist 2,5710,4,Strikeable,5771,6444,7206,673,1435,15734,69252,86472
Occupational Safety Specialist 2,5710,5,Strikeable,6051,6763,7562,712,1511,16424,72612,90744
Occupational Safety Specialist 2,5710,6,Strikeable,6350,7097,7923,747,1573,17162,76200,95076
Occupational Safety Specialist 2,5710,7,Strikeable,6664,7436,8314,772,1650,17936,79968,99768
Occupational Safety Specialist 2,5710,8,Strikeable,6982,7803,8713,821,1731,18721,83784,104556
Occupational Safety Specialist 2,5710,9,Strikeable,7327,8177,8713,850,1386,19571,87924,104556
Occupational Safety Specialist 2,5710,10,Strikeable,7678,8177,8713,499,1035,20437,92136,104556
Occupational Safety Specialist 3,5711,1,Strikeable,5503,6146,6866,643,1363,15073,66036,82392
Occupational Safety Specialist 3,5711,2,Strikeable,5771,6444,7206,673,1435,15734,69252,86472
Occupational Safety Specialist 3,5711,3,Strikeable,6051,6763,7562,712,1511,16424,72612,90744
Occupational Safety Specialist 3,5711,4,Strikeable,6350,7097,7923,747,1573,17162,76200,95076
Occupational Safety Specialist 3,5711,5,Strikeable,6664,7436,8314,772,1650,17936,79968,99768
Occupational Safety Specialist 3,5711,6,Strikeable,6982,7803,8713,821,1731,18721,83784,104556
Occupational Safety Specialist 3,5711,7,Strikeable,7327,8177,9143,850,1816,19571,87924,109716
Occupational Safety Specialist 3,5711,8,Strikeable,7678,8581,9589,903,1911,20437,92136,115068
Occupational Safety Specialist 3,5711,9,Strikeable,8057,8999,9589,942,1532,21372,96684,115068
Occupational Safety Specialist 3,5711,10,Strikeable,8450,8999,9589,549,1139,22341,101400,115068
Occupational Therapist,6508,1,Strikeable,6350,7097,7923,747,1573,17162,76200,95076
Occupational Therapist,6508,2,Strikeable,6664,7436,8314,772,1650,17936,79968,99768
Occupational Therapist,6508,3,Strikeable,6982,7803,8713,821,1731,18721,83784,104556
Occupational Therapist,6508,4,Strikeable,7327,8177,9143,850,1816,19571,87924,109716
Occupational Therapist,6508,5,Strikeable,7678,8581,9589,903,1911,20437,92136,115068
Occupational Therapist,6508,6,Strikeable,8057,8999,10065,942,2008,21372,96684,120780
Occupational Therapist,6508,7,Strikeable,8450,9447,10545,997,2095,22341,101400,126540
Occupational Therapist,6508,8,Strikeable,8870,9897,11065,1027,2195,23377,106440,132780
Occupational Therapist,6508,9,Strikeable,9293,10385,11065,1092,1772,24420,111516,132780
Occupational Therapist,6508,10,Strikeable,9751,10385,11065,634,1314,25550,117012,132780
Office Assistant 1,101,1,Strikeable,0,,,,,1500,0,
Office Assistant 1,101,2,Strikeable,0,,,,,1500,0,
Office Assistant 1,101,3,Strikeable,0,,,,,1500,0,
Office Assistant 1,101,4,Strikeable,0,,,,,1500,0,
Office Assistant 1,101,5,Strikeable,0,,,,,1500,0,
Office Assistant 1,101,6,Strikeable,0,,,,,1500,0,
Office Assistant 1,101,7,Strikeable,0,,,,,1500,0,
Office Assistant 1,101,8,Strikeable,3005,3427,3652,422,647,8912,36060,43824
Office Assistant 1,101,9,Strikeable,3095,3427,3652,332,557,9134,37140,43824
Office Assistant 1,101,10,Strikeable,3218,3427,3652,209,434,9437,38616,43824
Office Assistant 2,103,1,Strikeable,0,,,,,1500,0,
Office Assistant 2,103,2,Strikeable,0,,,,,1500,0,
Office Assistant 2,103,3,Strikeable,0,,,,,1500,0,
Office Assistant 2,103,4,Strikeable,0,,,,,1500,0,
Office Assistant 2,103,5,Strikeable,0,,,,,1500,0,
Office Assistant 2,103,6,Strikeable,3005,3427,3784,422,779,8912,36060,45408
Office Assistant 2,103,7,Strikeable,3095,3427,3784,332,689,9134,37140,45408
Office Assistant 2,103,8,Strikeable,3218,3552,3952,334,734,9437,38616,47424
Office Assistant 2,103,9,Strikeable,3335,3709,3952,374,617,9726,40020,47424
Office Assistant 2,103,10,Strikeable,3483,3709,3952,226,469,10091,41796,47424
Office Coordinator,801,1,Strikeable,3005,3427,3784,422,779,8912,36060,45408
Office Coordinator,801,2,Strikeable,3095,3427,3784,332,689,9134,37140,45408
Office Coordinator,801,3,Strikeable,3218,3552,3952,334,734,9437,38616,47424
Office Coordinator,801,4,Strikeable,3335,3709,4118,374,783,9726,40020,49416
Office Coordinator,801,5,Strikeable,3483,3865,4301,382,818,10091,41796,51612
Office Coordinator,801,6,Strikeable,3629,4036,4498,407,869,10451,43548,53976
Office Coordinator,801,7,Strikeable,3790,4222,4715,432,925,10848,45480,56580
Office Coordinator,801,8,Strikeable,3964,4425,4943,461,979,11277,47568,59316
Office Coordinator,801,9,Strikeable,4155,4639,4943,484,788,11748,49860,59316
Office Coordinator,801,10,Strikeable,4356,4639,4943,283,587,12244,52272,59316
Office Specialist 1,103,1,Strikeable,0,,,,,1500,0,
Office Specialist 1,103,2,Strikeable,0,,,,,1500,0,
Office Specialist 1,103,3,Strikeable,3005,3427,3784,422,779,8912,36060,45408
Office Specialist 1,103,4,Strikeable,3095,3427,3784,332,689,9134,37140,45408
Office Specialist 1,103,5,Strikeable,3218,3552,3952,334,734,9437,38616,47424
Office Specialist 1,103,6,Strikeable,3335,3709,4118,374,783,9726,40020,49416
Office Specialist 1,103,7,Strikeable,3483,3865,4301,382,818,10091,41796,51612
Office Specialist 1,103,8,Strikeable,3629,4036,4498,407,869,10451,43548,53976
Office Specialist 1,103,9,Strikeable,3790,4222,4498,432,708,10848,45480,53976
Office Specialist 1,103,10,Strikeable,3964,4222,4498,258,534,11277,47568,53976
Office Specialist 2,104,1,Strikeable,3005,3427,3784,422,779,8912,36060,45408
Office Specialist 2,104,2,Strikeable,3095,3427,3784,332,689,9134,37140,45408
Office Specialist 2,104,3,Strikeable,3218,3552,3952,334,734,9437,38616,47424
Office Specialist 2,104,4,Strikeable,3335,3709,4118,374,783,9726,40020,49416
Office Specialist 2,104,5,Strikeable,3483,3865,4301,382,818,10091,41796,51612
Office Specialist 2,104,6,Strikeable,3629,4036,4498,407,869,10451,43548,53976
Office Specialist 2,104,7,Strikeable,3790,4222,4715,432,925,10848,45480,56580
Office Specialist 2,104,8,Strikeable,3964,4425,4943,461,979,11277,47568,59316
Office Specialist 2,104,9,Strikeable,4155,4639,4943,484,788,11748,49860,59316
Office Specialist 2,104,10,Strikeable,4356,4639,4943,283,587,12244,52272,59316
Operations & Policy Analyst 1,870,1,Strikeable,4155,4639,5169,484,1014,11748,49860,62028
Operations & Policy Analyst 1,870,2,Strikeable,4356,4851,5420,495,1064,12244,52272,65040
Operations & Policy Analyst 1,870,3,Strikeable,4555,5086,5695,531,1140,12735,54660,68340
Operations & Policy Analyst 1,870,4,Strikeable,4776,5345,5964,569,1188,13280,57312,71568
Operations & Policy Analyst 1,870,5,Strikeable,5019,5598,6245,579,1226,13879,60228,74940
Operations & Policy Analyst 1,870,6,Strikeable,5256,5861,6549,605,1293,14464,63072,78588
Operations & Policy Analyst 1,870,7,Strikeable,5503,6146,6866,643,1363,15073,66036,82392
Operations & Policy Analyst 1,870,8,Strikeable,5771,6444,7206,673,1435,15734,69252,86472
Operations & Policy Analyst 1,870,9,Strikeable,6051,6763,7206,712,1155,16424,72612,86472
Operations & Policy Analyst 1,870,10,Strikeable,6350,6763,7206,413,856,17162,76200,86472
Operations & Policy Analyst 2,871,1,Strikeable,5019,5598,6245,579,1226,13879,60228,74940
Operations & Policy Analyst 2,871,2,Strikeable,5256,5861,6549,605,1293,14464,63072,78588
Operations & Policy Analyst 2,871,3,Strikeable,5503,6146,6866,643,1363,15073,66036,82392
Operations & Policy Analyst 2,871,4,Strikeable,5771,6444,7206,673,1435,15734,69252,86472
Operations & Policy Analyst 2,871,5,Strikeable,6051,6763,7562,712,1511,16424,72612,90744
Operations & Policy Analyst 2,871,6,Strikeable,6350,7097,7923,747,1573,17162,76200,95076
Operations & Policy Analyst 2,871,7,Strikeable,6664,7436,8314,772,1650,17936,79968,99768
Operations & Policy Analyst 2,871,8,Strikeable,6982,7803,8713,821,1731,18721,83784,104556
Operations & Policy Analyst 2,871,9,Strikeable,7327,8177,8713,850,1386,19571,87924,104556
Operations & Policy Analyst 2,871,10,Strikeable,7678,8177,8713,499,1035,20437,92136,104556
Operations & Policy Analyst 3,872,1,Strikeable,5771,6444,7206,673,1435,15734,69252,86472
Operations & Policy Analyst 3,872,2,Strikeable,6051,6763,7562,712,1511,16424,72612,90744
Operations & Policy Analyst 3,872,3,Strikeable,6350,7097,7923,747,1573,17162,76200,95076
Operations & Policy Analyst 3,872,4,Strikeable,6664,7436,8314,772,1650,17936,79968,99768
Operations & Policy Analyst 3,872,5,Strikeable,6982,7803,8713,821,1731,18721,83784,104556
Operations & Policy Analyst 3,872,6,Strikeable,7327,8177,9143,850,1816,19571,87924,109716
Operations & Policy Analyst 3,872,7,Strikeable,7678,8581,9589,903,1911,20437,92136,115068
Operations & Policy Analyst 3,872,8,Strikeable,8057,8999,10065,942,2008,21372,96684,120780
Operations & Policy Analyst 3,872,9,Strikeable,8450,9447,10065,997,1615,22341,101400,120780
Operations & Policy Analyst 3,872,10,Strikeable,8870,9447,10065,577,1195,23377,106440,120780
Operations & Policy Analyst 4,873,1,Strikeable,6350,7097,7923,747,1573,17162,76200,95076
Operations & Policy Analyst 4,873,2,Strikeable,6664,7436,8314,772,1650,17936,79968,99768
Operations & Policy Analyst 4,873,3,Strikeable,6982,7803,8713,821,1731,18721,83784,104556
Operations & Policy Analyst 4,873,4,Strikeable,7327,8177,9143,850,1816,19571,87924,109716
Operations & Policy Analyst 4,873,5,Strikeable,7678,8581,9589,903,1911,20437,92136,115068
Operations & Policy Analyst 4,873,6,Strikeable,8057,8999,10065,942,2008,21372,96684,120780
Operations & Policy Analyst 4,873,7,Strikeable,8450,9447,10545,997,2095,22341,101400,126540
Operations & Policy Analyst 4,873,8,Strikeable,8870,9897,11065,1027,2195,23377,106440,132780
Operations & Policy Analyst 4,873,9,Strikeable,9293,10385,11065,1092,1772,24420,111516,132780
Operations & Policy Analyst 4,873,10,Strikeable,9751,10385,11065,634,1314,25550,117012,132780
Painter,4001,1,Strikeable,3964,4425,4943,461,979,11277,47568,59316
Painter,4001,2,Strikeable,4155,4639,5169,484,1014,11748,49860,62028
Painter,4001,3,Strikeable,4356,4851,5420,495,1064,12244,52272,65040
Painter,4001,4,Strikeable,4555,5086,5695,531,1140,12735,54660,68340
Painter,4001,5,Strikeable,4776,5345,5964,569,1188,13280,57312,71568
Painter,4001,6,Strikeable,5019,5598,6245,579,1226,13879,60228,74940
Painter,4001,7,Strikeable,5256,5861,6549,605,1293,14464,63072,78588
Painter,4001,8,Strikeable,5503,6146,6866,643,1363,15073,66036,82392
Painter,4001,9,Strikeable,5771,6444,6866,673,1095,15734,69252,82392
Painter,4001,10,Strikeable,6051,6444,6866,393,815,16424,72612,82392
Paralegal,1534,1,Strikeable,4776,5345,5964,569,1188,13280,57312,71568
Paralegal,1534,2,Strikeable,5019,5598,6245,579,1226,13879,60228,74940
Paralegal,1534,3,Strikeable,5256,5861,6549,605,1293,14464,63072,78588
Paralegal,1534,4,Strikeable,5503,6146,6866,643,1363,15073,66036,82392
Paralegal,1534,5,Strikeable,5771,6444,7206,673,1435,15734,69252,86472
Paralegal,1534,6,Strikeable,6051,6763,7562,712,1511,16424,72612,90744
Paralegal,1534,7,Strikeable,6350,7097,7923,747,1573,17162,76200,95076
Paralegal,1534,8,Strikeable,6664,7436,8314,772,1650,17936,79968,99768
Paralegal,1534,9,Strikeable,6982,7803,8314,821,1332,18721,83784,99768
Paralegal,1534,10,Strikeable,7327,7803,8314,476,987,19571,87924,99768
Park Ranger 1,8434,1,Strikeable,0,3865,4301,3865,4301,1500,0,51612
Park Ranger 1,8434,2,Strikeable,3483,3865,4301,382,818,10091,41796,51612
Park Ranger 1,8434,3,Strikeable,3629,4036,4498,407,869,10451,43548,53976
Park Ranger 1,8434,4,Strikeable,3790,4222,4715,432,925,10848,45480,56580
Park Ranger 1,8434,5,Strikeable,3964,4425,4943,461,979,11277,47568,59316
Park Ranger 1,8434,6,Strikeable,4155,4639,5169,484,1014,11748,49860,62028
Park Ranger 1,8434,7,Strikeable,4356,4851,5420,495,1064,12244,52272,65040
Park Ranger 1,8434,8,Strikeable,4555,5086,5682,531,1127,12735,54660,68184
Park Ranger 1,8434,9,Strikeable,4776,5332,5682,556,906,13280,57312,68184
Park Ranger 1,8434,10,Strikeable,5007,5332,5682,325,675,13849,60084,68184
Park Ranger 2,8435,1,Strikeable,3629,4222,4715,593,1086,10451,43548,56580
Park Ranger 2,8435,2,Strikeable,3790,4222,4715,432,925,10848,45480,56580
Park Ranger 2,8435,3,Strikeable,3964,4425,4943,461,979,11277,47568,59316
Park Ranger 2,8435,4,Strikeable,4155,4639,5169,484,1014,11748,49860,62028
Park Ranger 2,8435,5,Strikeable,4356,4851,5420,495,1064,12244,52272,65040
Park Ranger 2,8435,6,Strikeable,4555,5086,5695,531,1140,12735,54660,68340
Park Ranger 2,8435,7,Strikeable,4776,5345,5964,569,1188,13280,57312,71568
Park Ranger 2,8435,8,Strikeable,5019,5598,6245,579,1226,13879,60228,74940
Park Ranger 2,8435,9,Strikeable,5256,5861,6245,605,989,14464,63072,74940
Park Ranger 2,8435,10,Strikeable,5503,5861,6245,358,742,15073,66036,74940
Park Ranger 3,8436,1,Strikeable,3964,4425,4943,461,979,11277,47568,59316
Park Ranger 3,8436,2,Strikeable,4155,4639,5169,484,1014,11748,49860,62028
Park Ranger 3,8436,3,Strikeable,4356,4851,5420,495,1064,12244,52272,65040
Park Ranger 3,8436,4,Strikeable,4555,5086,5695,531,1140,12735,54660,68340
Park Ranger 3,8436,5,Strikeable,4776,5345,5964,569,1188,13280,57312,71568
Park Ranger 3,8436,6,Strikeable,5019,5598,6245,579,1226,13879,60228,74940
Park Ranger 3,8436,7,Strikeable,5256,5861,6549,605,1293,14464,63072,78588
Park Ranger 3,8436,8,Strikeable,5503,6146,6866,643,1363,15073,66036,82392
Park Ranger 3,8436,9,Strikeable,5771,6444,6866,673,1095,15734,69252,82392
Park Ranger 3,8436,10,Strikeable,6051,6444,6866,393,815,16424,72612,82392
Park Ranger Assistant,8433,1,Strikeable,0,,,,,1500,0,
Park Ranger Assistant,8433,2,Strikeable,0,,,,,1500,0,
Park Ranger Assistant,8433,3,Strikeable,0,,,,,1500,0,
Park Ranger Assistant,8433,4,Strikeable,3005,3427,3784,422,779,8912,36060,45408
Park Ranger Assistant,8433,5,Strikeable,3095,3427,3784,332,689,9134,37140,45408
Park Ranger Assistant,8433,6,Strikeable,3218,3552,3952,334,734,9437,38616,47424
Park Ranger Assistant,8433,7,Strikeable,3335,3709,4118,374,783,9726,40020,49416
Park Ranger Assistant,8433,8,Strikeable,3483,3865,4301,382,818,10091,41796,51612
Park Ranger Assistant,8433,9,Strikeable,3629,4036,4301,407,672,10451,43548,51612
Park Ranger Assistant,8433,10,Strikeable,3790,4036,4301,246,511,10848,45480,51612
Park Specialist,8445,1,Strikeable,3218,3709,4118,491,900,9437,38616,49416
Park Specialist,8445,2,Strikeable,3335,3709,4118,374,783,9726,40020,49416
Park Specialist,8445,3,Strikeable,3483,3865,4301,382,818,10091,41796,51612
Park Specialist,8445,4,Strikeable,3629,4036,4498,407,869,10451,43548,53976
Park Specialist,8445,5,Strikeable,3790,4222,4715,432,925,10848,45480,56580
Park Specialist,8445,6,Strikeable,3964,4425,4943,461,979,11277,47568,59316
Park Specialist,8445,7,Strikeable,4155,4639,5169,484,1014,11748,49860,62028
Park Specialist,8445,8,Strikeable,4356,4851,5420,495,1064,12244,52272,65040
Park Specialist,8445,9,Strikeable,4555,5086,5420,531,865,12735,54660,65040
Park Specialist,8445,10,Strikeable,4776,5086,5420,310,644,13280,57312,65040
Parking Services Representative,5550,1,Strikeable,0,,,,,1500,0,
Parking Services Representative,5550,2,Strikeable,3005,3427,3784,422,779,8912,36060,45408
Parking Services Representative,5550,3,Strikeable,3095,3427,3784,332,689,9134,37140,45408
Parking Services Representative,5550,4,Strikeable,3218,3552,3952,334,734,9437,38616,47424
Parking Services Representative,5550,5,Strikeable,3335,3709,4118,374,783,9726,40020,49416
Parking Services Representative,5550,6,Strikeable,3483,3865,4301,382,818,10091,41796,51612
Parking Services Representative,5550,7,Strikeable,3629,4036,4498,407,869,10451,43548,53976
Parking Services Representative,5550,8,Strikeable,3790,4222,4715,432,925,10848,45480,56580
Parking Services Representative,5550,9,Strikeable,3964,4425,4715,461,751,11277,47568,56580
Parking Services Representative,5550,10,Strikeable,4155,4425,4715,270,560,11748,49860,56580
Parts Specialist 2,783,1,Strikeable,3629,4222,4715,593,1086,10451,43548,56580
Parts Specialist 2,783,2,Strikeable,3790,4222,4715,432,925,10848,45480,56580
Parts Specialist 2,783,3,Strikeable,3964,4425,4943,461,979,11277,47568,59316
Parts Specialist 2,783,4,Strikeable,4155,4639,5169,484,1014,11748,49860,62028
Parts Specialist 2,783,5,Strikeable,4356,4851,5420,495,1064,12244,52272,65040
Parts Specialist 2,783,6,Strikeable,4555,5086,5695,531,1140,12735,54660,68340
Parts Specialist 2,783,7,Strikeable,4776,5345,5964,569,1188,13280,57312,71568
Parts Specialist 2,783,8,Strikeable,5019,5598,6245,579,1226,13879,60228,74940
Parts Specialist 2,783,9,Strikeable,5256,5861,6245,605,989,14464,63072,74940
Parts Specialist 2,783,10,Strikeable,5503,5861,6245,358,742,15073,66036,74940
Payroll Analyst,314,1,Strikeable,3790,4425,4943,635,1153,10848,45480,59316
Payroll Analyst,314,2,Strikeable,3964,4425,4943,461,979,11277,47568,59316
Payroll Analyst,314,3,Strikeable,4155,4639,5169,484,1014,11748,49860,62028
Payroll Analyst,314,4,Strikeable,4356,4851,5420,495,1064,12244,52272,65040
Payroll Analyst,314,5,Strikeable,4555,5086,5695,531,1140,12735,54660,68340
Payroll Analyst,314,6,Strikeable,4776,5345,5964,569,1188,13280,57312,71568
Payroll Analyst,314,7,Strikeable,5019,5598,6245,579,1226,13879,60228,74940
Payroll Analyst,314,8,Strikeable,5256,5861,6549,605,1293,14464,63072,78588
Payroll Analyst,314,9,Strikeable,5503,6146,6549,643,1046,15073,66036,78588
Payroll Analyst,314,10,Strikeable,5771,6146,6549,375,778,15734,69252,78588
Pharmacist,6360,1,Strikeable,8870,9897,11065,1027,2195,23377,106440,132780
Pharmacist,6360,2,Strikeable,9293,10385,11622,1092,2329,24420,111516,139464
Pharmacist,6360,3,Strikeable,9751,10908,12187,1157,2436,25550,117012,146244
Pharmacist,6360,4,Strikeable,10242,11438,12785,1196,2543,26761,122904,153420
Pharmacist,6360,5,Strikeable,10740,11999,13419,1259,2679,27989,128880,161028
Pharmacist,6360,6,Strikeable,11267,12594,14080,1327,2813,29289,135204,168960
Pharmacist,6360,7,Strikeable,11825,13215,14775,1390,2950,30665,141900,177300
Pharmacist,6360,8,Strikeable,12408,13866,15503,1458,3095,32103,148896,186036
Pharmacist,6360,9,Strikeable,13020,14550,15503,1530,2483,33613,156240,186036
Pharmacist,6360,10,Strikeable,13662,14550,15503,888,1841,35196,163944,186036
Pharmacist 2,6363,1,Strikeable,9751,10908,12187,1157,2436,25550,117012,146244
Pharmacist 2,6363,2,Strikeable,10242,11438,12785,1196,2543,26761,122904,153420
Pharmacist 2,6363,3,Strikeable,10740,11999,13419,1259,2679,27989,128880,161028
Pharmacist 2,6363,4,Strikeable,11267,12594,14080,1327,2813,29289,135204,168960
Pharmacist 2,6363,5,Strikeable,11825,13215,14775,1390,2950,30665,141900,177300
Pharmacist 2,6363,6,Strikeable,12408,13866,15503,1458,3095,32103,148896,186036
Pharmacist 2,6363,7,Strikeable,13020,14550,16269,1530,3249,33613,156240,195228
Pharmacist 2,6363,8,Strikeable,13662,15269,17074,1607,3412,35196,163944,204888
Pharmacist 2,6363,9,Strikeable,14337,16024,17074,1687,2737,36861,172044,204888
Pharmacist 2,6363,10,Strikeable,15046,16024,17074,978,2028,38610,180552,204888
Pharmacist Resident,6361,1,Strikeable,4155,4639,5169,484,1014,11748,49860,62028
Pharmacist Resident,6361,2,Strikeable,4356,4851,5420,495,1064,12244,52272,65040
Pharmacist Resident,6361,3,Strikeable,4555,5086,5695,531,1140,12735,54660,68340
Pharmacist Resident,6361,4,Strikeable,4776,5345,5964,569,1188,13280,57312,71568
Pharmacist Resident,6361,5,Strikeable,5019,5598,6245,579,1226,13879,60228,74940
Pharmacist Resident,6361,6,Strikeable,5256,5861,6549,605,1293,14464,63072,78588
Pharmacist Resident,6361,7,Strikeable,5503,6146,6866,643,1363,15073,66036,82392
Pharmacist Resident,6361,8,Strikeable,5771,6444,7206,673,1435,15734,69252,86472
Pharmacist Resident,6361,9,Strikeable,6051,6763,7206,712,1155,16424,72612,86472
Pharmacist Resident,6361,10,Strikeable,6350,6763,7206,413,856,17162,76200,86472
Pharmacy Clerk & Technician 2,6388,1,Strikeable,3095,3709,4118,614,1023,9134,37140,49416
Pharmacy Clerk & Technician 2,6388,2,Strikeable,3218,3709,4118,491,900,9437,38616,49416
Pharmacy Clerk & Technician 2,6388,3,Strikeable,3335,3709,4118,374,783,9726,40020,49416
Pharmacy Clerk & Technician 2,6388,4,Strikeable,3483,3865,4301,382,818,10091,41796,51612
Pharmacy Clerk & Technician 2,6388,5,Strikeable,3629,4036,4498,407,869,10451,43548,53976
Pharmacy Clerk & Technician 2,6388,6,Strikeable,3790,4222,4715,432,925,10848,45480,56580
Pharmacy Clerk & Technician 2,6388,7,Strikeable,3964,4425,4943,461,979,11277,47568,59316
Pharmacy Clerk & Technician 2,6388,8,Strikeable,4155,4639,5169,484,1014,11748,49860,62028
Pharmacy Clerk & Technician 2,6388,9,Strikeable,4356,4851,5169,495,813,12244,52272,62028
Pharmacy Clerk & Technician 2,6388,10,Strikeable,4555,4851,5169,296,614,12735,54660,62028
Pharmacy Clerk & Technician 3,6389,1,Strikeable,3218,3865,4301,647,1083,9437,38616,51612
Pharmacy Clerk & Technician 3,6389,2,Strikeable,3335,3865,4301,530,966,9726,40020,51612
Pharmacy Clerk & Technician 3,6389,3,Strikeable,3483,3865,4301,382,818,10091,41796,51612
Pharmacy Clerk & Technician 3,6389,4,Strikeable,3629,4036,4498,407,869,10451,43548,53976
Pharmacy Clerk & Technician 3,6389,5,Strikeable,3790,4222,4715,432,925,10848,45480,56580
Pharmacy Clerk & Technician 3,6389,6,Strikeable,3964,4425,4943,461,979,11277,47568,59316
Pharmacy Clerk & Technician 3,6389,7,Strikeable,4155,4639,5169,484,1014,11748,49860,62028
Pharmacy Clerk & Technician 3,6389,8,Strikeable,4356,4851,5420,495,1064,12244,52272,65040
Pharmacy Clerk & Technician 3,6389,9,Strikeable,4555,5086,5420,531,865,12735,54660,65040
Pharmacy Clerk & Technician 3,6389,10,Strikeable,4776,5086,5420,310,644,13280,57312,65040
Physical Therapist,6503,1,Strikeable,6051,6763,7562,712,1511,16424,72612,90744
Physical Therapist,6503,2,Strikeable,6350,7097,7923,747,1573,17162,76200,95076
Physical Therapist,6503,3,Strikeable,6664,7436,8314,772,1650,17936,79968,99768
Physical Therapist,6503,4,Strikeable,6982,7803,8713,821,1731,18721,83784,104556
Physical Therapist,6503,5,Strikeable,7327,8177,9143,850,1816,19571,87924,109716
Physical Therapist,6503,6,Strikeable,7678,8581,9589,903,1911,20437,92136,115068
Physical Therapist,6503,7,Strikeable,8057,8999,10065,942,2008,21372,96684,120780
Physical Therapist,6503,8,Strikeable,8450,9447,10545,997,2095,22341,101400,126540
Physical Therapist,6503,9,Strikeable,8870,9897,10545,1027,1675,23377,106440,126540
Physical Therapist,6503,10,Strikeable,9293,9897,10545,604,1252,24420,111516,126540
Physical/Electronic Security Technician,4037,1,Strikeable,3629,4222,4715,593,1086,10451,43548,56580
Physical/Electronic Security Technician,4037,2,Strikeable,3790,4222,4715,432,925,10848,45480,56580
Physical/Electronic Security Technician,4037,3,Strikeable,3964,4425,4943,461,979,11277,47568,59316
Physical/Electronic Security Technician,4037,4,Strikeable,4155,4639,5169,484,1014,11748,49860,62028
Physical/Electronic Security Technician,4037,5,Strikeable,4356,4851,5420,495,1064,12244,52272,65040
Physical/Electronic Security Technician,4037,6,Strikeable,4555,5086,5695,531,1140,12735,54660,68340
Physical/Electronic Security Technician,4037,7,Strikeable,4776,5345,5964,569,1188,13280,57312,71568
Physical/Electronic Security Technician,4037,8,Strikeable,5019,5598,6245,579,1226,13879,60228,74940
Physical/Electronic Security Technician,4037,9,Strikeable,5256,5861,6245,605,989,14464,63072,74940
Physical/Electronic Security Technician,4037,10,Strikeable,5503,5861,6245,358,742,15073,66036,74940
Physical/Electronic Security Technician 3,4039,1,Strikeable,4356,4851,5420,495,1064,12244,52272,65040
Physical/Electronic Security Technician 3,4039,2,Strikeable,4555,5086,5695,531,1140,12735,54660,68340
Physical/Electronic Security Technician 3,4039,3,Strikeable,4776,5345,5964,569,1188,13280,57312,71568
Physical/Electronic Security Technician 3,4039,4,Strikeable,5019,5598,6245,579,1226,13879,60228,74940
Physical/Electronic Security Technician 3,4039,5,Strikeable,5256,5861,6549,605,1293,14464,63072,78588
Physical/Electronic Security Technician 3,4039,6,Strikeable,5503,6146,6866,643,1363,15073,66036,82392
Physical/Electronic Security Technician 3,4039,7,Strikeable,5771,6444,7206,673,1435,15734,69252,86472
Physical/Electronic Security Technician 3,4039,8,Strikeable,6051,6763,7562,712,1511,16424,72612,90744
Physical/Electronic Security Technician 3,4039,9,Strikeable,6350,7097,7562,747,1212,17162,76200,90744
Physical/Electronic Security Technician 3,4039,10,Strikeable,6664,7097,7562,433,898,17936,79968,90744
Physician's Assistant,6357,1,Strikeable,6664,7436,8314,772,1650,17936,79968,99768
Physician's Assistant,6357,2,Strikeable,6982,7803,8713,821,1731,18721,83784,104556
Physician's Assistant,6357,3,Strikeable,7327,8177,9143,850,1816,19571,87924,109716
Physician's Assistant,6357,4,Strikeable,7678,8581,9589,903,1911,20437,92136,115068
Physician's Assistant,6357,5,Strikeable,8057,8999,10065,942,2008,21372,96684,120780
Physician's Assistant,6357,6,Strikeable,8450,9447,10545,997,2095,22341,101400,126540
Physician's Assistant,6357,7,Strikeable,8870,9897,11065,1027,2195,23377,106440,132780
Physician's Assistant,6357,8,Strikeable,9293,10385,11622,1092,2329,24420,111516,139464
Physician's Assistant,6357,9,Strikeable,9751,10908,11622,1157,1871,25550,117012,139464
Physician's Assistant,6357,10,Strikeable,10242,10908,11622,666,1380,26761,122904,139464
Planner 2,1097,1,Strikeable,5019,5598,6245,579,1226,13879,60228,74940
Planner 2,1097,2,Strikeable,5256,5861,6549,605,1293,14464,63072,78588
Planner 2,1097,3,Strikeable,5503,6146,6866,643,1363,15073,66036,82392
Planner 2,1097,4,Strikeable,5771,6444,7206,673,1435,15734,69252,86472
Planner 2,1097,5,Strikeable,6051,6763,7562,712,1511,16424,72612,90744
Planner 2,1097,6,Strikeable,6350,7097,7923,747,1573,17162,76200,95076
Planner 2,1097,7,Strikeable,6664,7436,8314,772,1650,17936,79968,99768
Planner 2,1097,8,Strikeable,6982,7803,8713,821,1731,18721,83784,104556
Planner 2,1097,9,Strikeable,7327,8177,8713,850,1386,19571,87924,104556
Planner 2,1097,10,Strikeable,7678,8177,8713,499,1035,20437,92136,104556
Plumber,4005,1,Strikeable,4356,4851,5420,495,1064,12244,52272,65040
Plumber,4005,2,Strikeable,4555,5086,5695,531,1140,12735,54660,68340
Plumber,4005,3,Strikeable,4776,5345,5964,569,1188,13280,57312,71568
Plumber,4005,4,Strikeable,5019,5598,6245,579,1226,13879,60228,74940
Plumber,4005,5,Strikeable,5256,5861,6549,605,1293,14464,63072,78588
Plumber,4005,6,Strikeable,5503,6146,6866,643,1363,15073,66036,82392
Plumber,4005,7,Strikeable,5771,6444,7206,673,1435,15734,69252,86472
Plumber,4005,8,Strikeable,6051,6763,7562,712,1511,16424,72612,90744
Plumber,4005,9,Strikeable,6350,7097,7562,747,1212,17162,76200,90744
Plumber,4005,10,Strikeable,6664,7097,7562,433,898,17936,79968,90744
Preadmissions Screening Specialist,6684,1,Strikeable,4356,4851,5420,495,1064,12244,52272,65040
Preadmissions Screening Specialist,6684,2,Strikeable,4555,5086,5695,531,1140,12735,54660,68340
Preadmissions Screening Specialist,6684,3,Strikeable,4776,5345,5964,569,1188,13280,57312,71568
Preadmissions Screening Specialist,6684,4,Strikeable,5019,5598,6245,579,1226,13879,60228,74940
Preadmissions Screening Specialist,6684,5,Strikeable,5256,5861,6549,605,1293,14464,63072,78588
Preadmissions Screening Specialist,6684,6,Strikeable,5503,6146,6866,643,1363,15073,66036,82392
Preadmissions Screening Specialist,6684,7,Strikeable,5771,6444,7206,673,1435,15734,69252,86472
Preadmissions Screening Specialist,6684,8,Strikeable,6051,6763,7562,712,1511,16424,72612,90744
Preadmissions Screening Specialist,6684,9,Strikeable,6350,7097,7562,747,1212,17162,76200,90744
Preadmissions Screening Specialist,6684,10,Strikeable,6664,7097,7562,433,898,17936,79968,90744
Print Services Technician,3446,1,Strikeable,3095,3552,3952,457,857,9134,37140,47424
Print Services Technician,3446,2,Strikeable,3218,3552,3952,334,734,9437,38616,47424
Print Services Technician,3446,3,Strikeable,3335,3709,4118,374,783,9726,40020,49416
Print Services Technician,3446,4,Strikeable,3483,3865,4301,382,818,10091,41796,51612
Print Services Technician,3446,5,Strikeable,3629,4036,4498,407,869,10451,43548,53976
Print Services Technician,3446,6,Strikeable,3790,4222,4715,432,925,10848,45480,56580
Print Services Technician,3446,7,Strikeable,3964,4425,4943,461,979,11277,47568,59316
Print Services Technician,3446,8,Strikeable,4155,4639,5169,484,1014,11748,49860,62028
Print Services Technician,3446,9,Strikeable,4356,4851,5169,495,813,12244,52272,62028
Print Services Technician,3446,10,Strikeable,4555,4851,5169,296,614,12735,54660,62028
Printing Production Coordinator,3475,1,Strikeable,4155,4639,5169,484,1014,11748,49860,62028
Printing Production Coordinator,3475,2,Strikeable,4356,4851,5420,495,1064,12244,52272,65040
Printing Production Coordinator,3475,3,Strikeable,4555,5086,5695,531,1140,12735,54660,68340
Printing Production Coordinator,3475,4,Strikeable,4776,5345,5964,569,1188,13280,57312,71568
Printing Production Coordinator,3475,5,Strikeable,5019,5598,6245,579,1226,13879,60228,74940
Printing Production Coordinator,3475,6,Strikeable,5256,5861,6549,605,1293,14464,63072,78588
Printing Production Coordinator,3475,7,Strikeable,5503,6146,6866,643,1363,15073,66036,82392
Printing Production Coordinator,3475,8,Strikeable,5771,6444,7206,673,1435,15734,69252,86472
Printing Production Coordinator,3475,9,Strikeable,6051,6763,7206,712,1155,16424,72612,86472
Printing Production Coordinator,3475,10,Strikeable,6350,6763,7206,413,856,17162,76200,86472
Procurement & Contract Specialist 1,436,1,Strikeable,4155,4639,5169,484,1014,11748,49860,62028
Procurement & Contract Specialist 1,436,2,Strikeable,4356,4851,5420,495,1064,12244,52272,65040
Procurement & Contract Specialist 1,436,3,Strikeable,4555,5086,5695,531,1140,12735,54660,68340
Procurement & Contract Specialist 1,436,4,Strikeable,4776,5345,5964,569,1188,13280,57312,71568
Procurement & Contract Specialist 1,436,5,Strikeable,5019,5598,6245,579,1226,13879,60228,74940
Procurement & Contract Specialist 1,436,6,Strikeable,5256,5861,6549,605,1293,14464,63072,78588
Procurement & Contract Specialist 1,436,7,Strikeable,5503,6146,6866,643,1363,15073,66036,82392
Procurement & Contract Specialist 1,436,8,Strikeable,5771,6444,7206,673,1435,15734,69252,86472
Procurement & Contract Specialist 1,436,9,Strikeable,6051,6763,7206,712,1155,16424,72612,86472
Procurement & Contract Specialist 1,436,10,Strikeable,6350,6763,7206,413,856,17162,76200,86472
Procurement & Contract Specialist 2,437,1,Strikeable,5019,5598,6245,579,1226,13879,60228,74940
Procurement & Contract Specialist 2,437,2,Strikeable,5256,5861,6549,605,1293,14464,63072,78588
Procurement & Contract Specialist 2,437,3,Strikeable,5503,6146,6866,643,1363,15073,66036,82392
Procurement & Contract Specialist 2,437,4,Strikeable,5771,6444,7206,673,1435,15734,69252,86472
Procurement & Contract Specialist 2,437,5,Strikeable,6051,6763,7562,712,1511,16424,72612,90744
Procurement & Contract Specialist 2,437,6,Strikeable,6350,7097,7923,747,1573,17162,76200,95076
Procurement & Contract Specialist 2,437,7,Strikeable,6664,7436,8314,772,1650,17936,79968,99768
Procurement & Contract Specialist 2,437,8,Strikeable,6982,7803,8713,821,1731,18721,83784,104556
Procurement & Contract Specialist 2,437,9,Strikeable,7327,8177,8713,850,1386,19571,87924,104556
Procurement & Contract Specialist 2,437,10,Strikeable,7678,8177,8713,499,1035,20437,92136,104556
Procurement & Contract Specialist 3,438,1,Strikeable,5503,6146,6866,643,1363,15073,66036,82392
Procurement & Contract Specialist 3,438,2,Strikeable,5771,6444,7206,673,1435,15734,69252,86472
Procurement & Contract Specialist 3,438,3,Strikeable,6051,6763,7562,712,1511,16424,72612,90744
Procurement & Contract Specialist 3,438,4,Strikeable,6350,7097,7923,747,1573,17162,76200,95076
Procurement & Contract Specialist 3,438,5,Strikeable,6664,7436,8314,772,1650,17936,79968,99768
Procurement & Contract Specialist 3,438,6,Strikeable,6982,7803,8713,821,1731,18721,83784,104556
Procurement & Contract Specialist 3,438,7,Strikeable,7327,8177,9143,850,1816,19571,87924,109716
Procurement & Contract Specialist 3,438,8,Strikeable,7678,8581,9589,903,1911,20437,92136,115068
Procurement & Contract Specialist 3,438,9,Strikeable,8057,8999,9589,942,1532,21372,96684,115068
Procurement & Contract Specialist 3,438,10,Strikeable,8450,8999,9589,549,1139,22341,101400,115068
Procurement And Contract Assistant,435,1,Strikeable,3483,4036,4498,553,1015,10091,41796,53976
Procurement And Contract Assistant,435,2,Strikeable,3629,4036,4498,407,869,10451,43548,53976
Procurement And Contract Assistant,435,3,Strikeable,3790,4222,4715,432,925,10848,45480,56580
Procurement And Contract Assistant,435,4,Strikeable,3964,4425,4943,461,979,11277,47568,59316
Procurement And Contract Assistant,435,5,Strikeable,4155,4639,5169,484,1014,11748,49860,62028
Procurement And Contract Assistant,435,6,Strikeable,4356,4851,5420,495,1064,12244,52272,65040
Procurement And Contract Assistant,435,7,Strikeable,4555,5086,5695,531,1140,12735,54660,68340
Procurement And Contract Assistant,435,8,Strikeable,4776,5345,5964,569,1188,13280,57312,71568
Procurement And Contract Assistant,435,9,Strikeable,5019,5598,5964,579,945,13879,60228,71568
Procurement And Contract Assistant,435,10,Strikeable,5256,5598,5964,342,708,14464,63072,71568
Program Analyst 1,860,1,Strikeable,4155,4639,5169,484,1014,11748,49860,62028
Program Analyst 1,860,2,Strikeable,4356,4851,5420,495,1064,12244,52272,65040
Program Analyst 1,860,3,Strikeable,4555,5086,5695,531,1140,12735,54660,68340
Program Analyst 1,860,4,Strikeable,4776,5345,5964,569,1188,13280,57312,71568
Program Analyst 1,860,5,Strikeable,5019,5598,6245,579,1226,13879,60228,74940
Program Analyst 1,860,6,Strikeable,5256,5861,6549,605,1293,14464,63072,78588
Program Analyst 1,860,7,Strikeable,5503,6146,6866,643,1363,15073,66036,82392
Program Analyst 1,860,8,Strikeable,5771,6444,7206,673,1435,15734,69252,86472
Program Analyst 1,860,9,Strikeable,6051,6763,7206,712,1155,16424,72612,86472
Program Analyst 1,860,10,Strikeable,6350,6763,7206,413,856,17162,76200,86472
Program Analyst 2,861,1,Strikeable,5019,5598,6245,579,1226,13879,60228,74940
Program Analyst 2,861,2,Strikeable,5256,5861,6549,605,1293,14464,63072,78588
Program Analyst 2,861,3,Strikeable,5503,6146,6866,643,1363,15073,66036,82392
Program Analyst 2,861,4,Strikeable,5771,6444,7206,673,1435,15734,69252,86472
Program Analyst 2,861,5,Strikeable,6051,6763,7562,712,1511,16424,72612,90744
Program Analyst 2,861,6,Strikeable,6350,7097,7923,747,1573,17162,76200,95076
Program Analyst 2,861,7,Strikeable,6664,7436,8314,772,1650,17936,79968,99768
Program Analyst 2,861,8,Strikeable,6982,7803,8713,821,1731,18721,83784,104556
Program Analyst 2,861,9,Strikeable,7327,8177,8713,850,1386,19571,87924,104556
Program Analyst 2,861,10,Strikeable,7678,8177,8713,499,1035,20437,92136,104556
Program Analyst 3,863,1,Strikeable,5503,6146,6866,643,1363,15073,66036,82392
Program Analyst 3,863,2,Strikeable,5771,6444,7206,673,1435,15734,69252,86472
Program Analyst 3,863,3,Strikeable,6051,6763,7562,712,1511,16424,72612,90744
Program Analyst 3,863,4,Strikeable,6350,7097,7923,747,1573,17162,76200,95076
Program Analyst 3,863,5,Strikeable,6664,7436,8314,772,1650,17936,79968,99768
Program Analyst 3,863,6,Strikeable,6982,7803,8713,821,1731,18721,83784,104556
Program Analyst 3,863,7,Strikeable,7327,8177,9143,850,1816,19571,87924,109716
Program Analyst 3,863,8,Strikeable,7678,8581,9589,903,1911,20437,92136,115068
Program Analyst 3,863,9,Strikeable,8057,8999,9589,942,1532,21372,96684,115068
Program Analyst 3,863,10,Strikeable,8450,8999,9589,549,1139,22341,101400,115068
Program Analyst 4,863,1,Strikeable,6051,6763,7562,712,1511,16424,72612,90744
Program Analyst 4,863,2,Strikeable,6350,7097,7923,747,1573,17162,76200,95076
Program Analyst 4,863,3,Strikeable,6664,7436,8314,772,1650,17936,79968,99768
Program Analyst 4,863,4,Strikeable,6982,7803,8713,821,1731,18721,83784,104556
Program Analyst 4,863,5,Strikeable,7327,8177,9143,850,1816,19571,87924,109716
Program Analyst 4,863,6,Strikeable,7678,8581,9589,903,1911,20437,92136,115068
Program Analyst 4,863,7,Strikeable,8057,8999,10065,942,2008,21372,96684,120780
Program Analyst 4,863,8,Strikeable,8450,9447,10545,997,2095,22341,101400,126540
Program Analyst 4,863,9,Strikeable,8870,9897,10545,1027,1675,23377,106440,126540
Program Analyst 4,863,10,Strikeable,9293,9897,10545,604,1252,24420,111516,126540
Project Manager 1,854,1,Strikeable,5019,5598,6245,579,1226,13879,60228,74940
Project Manager 1,854,2,Strikeable,5256,5861,6549,605,1293,14464,63072,78588
Project Manager 1,854,3,Strikeable,5503,6146,6866,643,1363,15073,66036,82392
Project Manager 1,854,4,Strikeable,5771,6444,7206,673,1435,15734,69252,86472
Project Manager 1,854,5,Strikeable,6051,6763,7562,712,1511,16424,72612,90744
Project Manager 1,854,6,Strikeable,6350,7097,7923,747,1573,17162,76200,95076
Project Manager 1,854,7,Strikeable,6664,7436,8314,772,1650,17936,79968,99768
Project Manager 1,854,8,Strikeable,6982,7803,8713,821,1731,18721,83784,104556
Project Manager 1,854,9,Strikeable,7327,8177,8713,850,1386,19571,87924,104556
Project Manager 1,854,10,Strikeable,7678,8177,8713,499,1035,20437,92136,104556
Project Manager 2,855,1,Strikeable,5771,6444,7206,673,1435,15734,69252,86472
Project Manager 2,855,2,Strikeable,6051,6763,7562,712,1511,16424,72612,90744
Project Manager 2,855,3,Strikeable,6350,7097,7923,747,1573,17162,76200,95076
Project Manager 2,855,4,Strikeable,6664,7436,8314,772,1650,17936,79968,99768
Project Manager 2,855,5,Strikeable,6982,7803,8713,821,1731,18721,83784,104556
Project Manager 2,855,6,Strikeable,7327,8177,9143,850,1816,19571,87924,109716
Project Manager 2,855,7,Strikeable,7678,8581,9589,903,1911,20437,92136,115068
Project Manager 2,855,8,Strikeable,8057,8999,10065,942,2008,21372,96684,120780
Project Manager 2,855,9,Strikeable,8450,9447,10065,997,1615,22341,101400,120780
Project Manager 2,855,10,Strikeable,8870,9447,10065,577,1195,23377,106440,120780
Project Manager 3,856,1,Strikeable,6350,7097,7923,747,1573,17162,76200,95076
Project Manager 3,856,2,Strikeable,6664,7436,8314,772,1650,17936,79968,99768
Project Manager 3,856,3,Strikeable,6982,7803,8713,821,1731,18721,83784,104556
Project Manager 3,856,4,Strikeable,7327,8177,9143,850,1816,19571,87924,109716
Project Manager 3,856,5,Strikeable,7678,8581,9589,903,1911,20437,92136,115068
Project Manager 3,856,6,Strikeable,8057,8999,10065,942,2008,21372,96684,120780
Project Manager 3,856,7,Strikeable,8450,9447,10545,997,2095,22341,101400,126540
Project Manager 3,856,8,Strikeable,8870,9897,11065,1027,2195,23377,106440,132780
Project Manager 3,856,9,Strikeable,9293,10385,11065,1092,1772,24420,111516,132780
Project Manager 3,856,10,Strikeable,9751,10385,11065,634,1314,25550,117012,132780
Psychiatric Social Worker,6730,1,Strikeable,5503,6146,6866,643,1363,15073,66036,82392
Psychiatric Social Worker,6730,2,Strikeable,5771,6444,7206,673,1435,15734,69252,86472
Psychiatric Social Worker,6730,3,Strikeable,6051,6763,7562,712,1511,16424,72612,90744
Psychiatric Social Worker,6730,4,Strikeable,6350,7097,7923,747,1573,17162,76200,95076
Psychiatric Social Worker,6730,5,Strikeable,6664,7436,8314,772,1650,17936,79968,99768
Psychiatric Social Worker,6730,6,Strikeable,6982,7803,8713,821,1731,18721,83784,104556
Psychiatric Social Worker,6730,7,Strikeable,7327,8177,9143,850,1816,19571,87924,109716
Psychiatric Social Worker,6730,8,Strikeable,7678,8581,9589,903,1911,20437,92136,115068
Psychiatric Social Worker,6730,9,Strikeable,8057,8999,9589,942,1532,21372,96684,115068
Psychiatric Social Worker,6730,10,Strikeable,8450,8999,9589,549,1139,22341,101400,115068
Public Affairs Specialist 1,864,1,Strikeable,4555,5086,5695,531,1140,12735,54660,68340
Public Affairs Specialist 1,864,2,Strikeable,4776,5345,5964,569,1188,13280,57312,71568
Public Affairs Specialist 1,864,3,Strikeable,5019,5598,6245,579,1226,13879,60228,74940
Public Affairs Specialist 1,864,4,Strikeable,5256,5861,6549,605,1293,14464,63072,78588
Public Affairs Specialist 1,864,5,Strikeable,5503,6146,6866,643,1363,15073,66036,82392
Public Affairs Specialist 1,864,6,Strikeable,5771,6444,7206,673,1435,15734,69252,86472
Public Affairs Specialist 1,864,7,Strikeable,6051,6763,7562,712,1511,16424,72612,90744
Public Affairs Specialist 1,864,8,Strikeable,6350,7097,7923,747,1573,17162,76200,95076
Public Affairs Specialist 1,864,9,Strikeable,6664,7436,7923,772,1259,17936,79968,95076
Public Affairs Specialist 1,864,10,Strikeable,6982,7436,7923,454,941,18721,83784,95076
Public Affairs Specialist 2,865,1,Strikeable,5503,6146,6866,643,1363,15073,66036,82392
Public Affairs Specialist 2,865,2,Strikeable,5771,6444,7206,673,1435,15734,69252,86472
Public Affairs Specialist 2,865,3,Strikeable,6051,6763,7562,712,1511,16424,72612,90744
Public Affairs Specialist 2,865,4,Strikeable,6350,7097,7923,747,1573,17162,76200,95076
Public Affairs Specialist 2,865,5,Strikeable,6664,7436,8314,772,1650,17936,79968,99768
Public Affairs Specialist 2,865,6,Strikeable,6982,7803,8713,821,1731,18721,83784,104556
Public Affairs Specialist 2,865,7,Strikeable,7327,8177,9143,850,1816,19571,87924,109716
Public Affairs Specialist 2,865,8,Strikeable,7678,8581,9589,903,1911,20437,92136,115068
Public Affairs Specialist 2,865,9,Strikeable,8057,8999,9589,942,1532,21372,96684,115068
Public Affairs Specialist 2,865,10,Strikeable,8450,8999,9589,549,1139,22341,101400,115068
Public Affairs Specialist 3,866,1,Strikeable,6051,6763,7562,712,1511,16424,72612,90744
Public Affairs Specialist 3,866,2,Strikeable,6350,7097,7923,747,1573,17162,76200,95076
Public Affairs Specialist 3,866,3,Strikeable,6664,7436,8314,772,1650,17936,79968,99768
Public Affairs Specialist 3,866,4,Strikeable,6982,7803,8713,821,1731,18721,83784,104556
Public Affairs Specialist 3,866,5,Strikeable,7327,8177,9143,850,1816,19571,87924,109716
Public Affairs Specialist 3,866,6,Strikeable,7678,8581,9589,903,1911,20437,92136,115068
Public Affairs Specialist 3,866,7,Strikeable,8057,8999,10065,942,2008,21372,96684,120780
Public Affairs Specialist 3,866,8,Strikeable,8450,9447,10545,997,2095,22341,101400,126540
Public Affairs Specialist 3,866,9,Strikeable,8870,9897,10545,1027,1675,23377,106440,126540
Public Affairs Specialist 3,866,10,Strikeable,9293,9897,10545,604,1252,24420,111516,126540
Public Health Educator 1,3337,1,Strikeable,4356,4851,5420,495,1064,12244,52272,65040
Public Health Educator 1,3337,2,Strikeable,4555,5086,5695,531,1140,12735,54660,68340
Public Health Educator 1,3337,3,Strikeable,4776,5345,5964,569,1188,13280,57312,71568
Public Health Educator 1,3337,4,Strikeable,5019,5598,6245,579,1226,13879,60228,74940
Public Health Educator 1,3337,5,Strikeable,5256,5861,6549,605,1293,14464,63072,78588
Public Health Educator 1,3337,6,Strikeable,5503,6146,6866,643,1363,15073,66036,82392
Public Health Educator 1,3337,7,Strikeable,5771,6444,7206,673,1435,15734,69252,86472
Public Health Educator 1,3337,8,Strikeable,6051,6763,7562,712,1511,16424,72612,90744
Public Health Educator 1,3337,9,Strikeable,6350,7097,7562,747,1212,17162,76200,90744
Public Health Educator 1,3337,10,Strikeable,6664,7097,7562,433,898,17936,79968,90744
Public Health Educator 2,3338,1,Strikeable,4776,5345,5964,569,1188,13280,57312,71568
Public Health Educator 2,3338,2,Strikeable,5019,5598,6245,579,1226,13879,60228,74940
Public Health Educator 2,3338,3,Strikeable,5256,5861,6549,605,1293,14464,63072,78588
Public Health Educator 2,3338,4,Strikeable,5503,6146,6866,643,1363,15073,66036,82392
Public Health Educator 2,3338,5,Strikeable,5771,6444,7206,673,1435,15734,69252,86472
Public Health Educator 2,3338,6,Strikeable,6051,6763,7562,712,1511,16424,72612,90744
Public Health Educator 2,3338,7,Strikeable,6350,7097,7923,747,1573,17162,76200,95076
Public Health Educator 2,3338,8,Strikeable,6664,7436,8314,772,1650,17936,79968,99768
Public Health Educator 2,3338,9,Strikeable,6982,7803,8314,821,1332,18721,83784,99768
Public Health Educator 2,3338,10,Strikeable,7327,7803,8314,476,987,19571,87924,99768
Public Health Nurse 2,6339,1,Strikeable,6756,7534,8409,778,1653,18163,81072,100908
Public Health Nurse 2,6339,2,Strikeable,7074,7892,8810,818,1736,18947,84888,105720
Public Health Nurse 2,6339,3,Strikeable,7410,8269,9226,859,1816,19776,88920,110712
Public Health Nurse 2,6339,4,Strikeable,7764,8658,9667,894,1903,20649,93168,116004
Public Health Nurse 2,6339,5,Strikeable,8130,9073,10172,943,2042,21552,97560,122064
Public Health Nurse 2,6339,6,Strikeable,8519,9547,10604,1028,2085,22511,102228,127248
Public Health Nurse 2,6339,7,Strikeable,8964,9952,11108,988,2144,23609,107568,133296
Public Health Nurse 2,6339,8,Strikeable,9345,10425,11636,1080,2291,24549,112140,139632
Public Health Nurse 2,6339,9,Strikeable,9789,10921,11636,1132,1847,25644,117468,139632
Public Health Nurse 2,6339,10,Strikeable,10254,10921,11636,667,1382,26791,123048,139632
Public Health Toxicologist 1,3433,1,Strikeable,5503,6146,6866,643,1363,15073,66036,82392
Public Health Toxicologist 1,3433,2,Strikeable,5771,6444,7206,673,1435,15734,69252,86472
Public Health Toxicologist 1,3433,3,Strikeable,6051,6763,7562,712,1511,16424,72612,90744
Public Health Toxicologist 1,3433,4,Strikeable,6350,7097,7923,747,1573,17162,76200,95076
Public Health Toxicologist 1,3433,5,Strikeable,6664,7436,8314,772,1650,17936,79968,99768
Public Health Toxicologist 1,3433,6,Strikeable,6982,7803,8713,821,1731,18721,83784,104556
Public Health Toxicologist 1,3433,7,Strikeable,7327,8177,9143,850,1816,19571,87924,109716
Public Health Toxicologist 1,3433,8,Strikeable,7678,8581,9589,903,1911,20437,92136,115068
Public Health Toxicologist 1,3433,9,Strikeable,8057,8999,9589,942,1532,21372,96684,115068
Public Health Toxicologist 1,3433,10,Strikeable,8450,8999,9589,549,1139,22341,101400,115068
Public Service Representative 2,333,1,Strikeable,0,,,,,1500,0,
Public Service Representative 2,333,2,Strikeable,0,,,,,1500,0,
Public Service Representative 2,333,3,Strikeable,3005,3427,3784,422,779,8912,36060,45408
Public Service Representative 2,333,4,Strikeable,3095,3427,3784,332,689,9134,37140,45408
Public Service Representative 2,333,5,Strikeable,3218,3552,3952,334,734,9437,38616,47424
Public Service Representative 2,333,6,Strikeable,3335,3709,4118,374,783,9726,40020,49416
Public Service Representative 2,333,7,Strikeable,3483,3865,4301,382,818,10091,41796,51612
Public Service Representative 2,333,8,Strikeable,3629,4036,4498,407,869,10451,43548,53976
Public Service Representative 2,333,9,Strikeable,3790,4222,4498,432,708,10848,45480,53976
Public Service Representative 2,333,10,Strikeable,3964,4222,4498,258,534,11277,47568,53976
Public Service Representative 3,333,1,Strikeable,3005,3427,3784,422,779,8912,36060,45408
Public Service Representative 3,333,2,Strikeable,3095,3427,3784,332,689,9134,37140,45408
Public Service Representative 3,333,3,Strikeable,3218,3552,3952,334,734,9437,38616,47424
Public Service Representative 3,333,4,Strikeable,3335,3709,4118,374,783,9726,40020,49416
Public Service Representative 3,333,5,Strikeable,3483,3865,4301,382,818,10091,41796,51612
Public Service Representative 3,333,6,Strikeable,3629,4036,4498,407,869,10451,43548,53976
Public Service Representative 3,333,7,Strikeable,3790,4222,4715,432,925,10848,45480,56580
Public Service Representative 3,333,8,Strikeable,3964,4425,4943,461,979,11277,47568,59316
Public Service Representative 3,333,9,Strikeable,4155,4639,4943,484,788,11748,49860,59316
Public Service Representative 3,333,10,Strikeable,4356,4639,4943,283,587,12244,52272,59316
Public Service Representative 4,334,1,Strikeable,3629,4222,4715,593,1086,10451,43548,56580
Public Service Representative 4,334,2,Strikeable,3790,4222,4715,432,925,10848,45480,56580
Public Service Representative 4,334,3,Strikeable,3964,4425,4943,461,979,11277,47568,59316
Public Service Representative 4,334,4,Strikeable,4155,4639,5169,484,1014,11748,49860,62028
Public Service Representative 4,334,5,Strikeable,4356,4851,5420,495,1064,12244,52272,65040
Public Service Representative 4,334,6,Strikeable,4555,5086,5695,531,1140,12735,54660,68340
Public Service Representative 4,334,7,Strikeable,4776,5345,5964,569,1188,13280,57312,71568
Public Service Representative 4,334,8,Strikeable,5019,5598,6245,579,1226,13879,60228,74940
Public Service Representative 4,334,9,Strikeable,5256,5861,6245,605,989,14464,63072,74940
Public Service Representative 4,334,10,Strikeable,5503,5861,6245,358,742,15073,66036,74940
Radiologic Technologist,6348,1,Strikeable,4555,5086,5695,531,1140,12735,54660,68340
Radiologic Technologist,6348,2,Strikeable,4776,5345,5964,569,1188,13280,57312,71568
Radiologic Technologist,6348,3,Strikeable,5019,5598,6245,579,1226,13879,60228,74940
Radiologic Technologist,6348,4,Strikeable,5256,5861,6549,605,1293,14464,63072,78588
Radiologic Technologist,6348,5,Strikeable,5503,6146,6866,643,1363,15073,66036,82392
Radiologic Technologist,6348,6,Strikeable,5771,6444,7206,673,1435,15734,69252,86472
Radiologic Technologist,6348,7,Strikeable,6051,6763,7562,712,1511,16424,72612,90744
Radiologic Technologist,6348,8,Strikeable,6350,7097,7923,747,1573,17162,76200,95076
Radiologic Technologist,6348,9,Strikeable,6664,7436,7923,772,1259,17936,79968,95076
Radiologic Technologist,6348,10,Strikeable,6982,7436,7923,454,941,18721,83784,95076
Rehabilitation Instructor For The Blind,3333,1,Strikeable,4155,4639,5169,484,1014,11748,49860,62028
Rehabilitation Instructor For The Blind,3333,2,Strikeable,4356,4851,5420,495,1064,12244,52272,65040
Rehabilitation Instructor For The Blind,3333,3,Strikeable,4555,5086,5695,531,1140,12735,54660,68340
Rehabilitation Instructor For The Blind,3333,4,Strikeable,4776,5345,5964,569,1188,13280,57312,71568
Rehabilitation Instructor For The Blind,3333,5,Strikeable,5019,5598,6245,579,1226,13879,60228,74940
Rehabilitation Instructor For The Blind,3333,6,Strikeable,5256,5861,6549,605,1293,14464,63072,78588
Rehabilitation Instructor For The Blind,3333,7,Strikeable,5503,6146,6866,643,1363,15073,66036,82392
Rehabilitation Instructor For The Blind,3333,8,Strikeable,5771,6444,7206,673,1435,15734,69252,86472
Rehabilitation Instructor For The Blind,3333,9,Strikeable,6051,6763,7206,712,1155,16424,72612,86472
Rehabilitation Instructor For The Blind,3333,10,Strikeable,6350,6763,7206,413,856,17162,76200,86472
Rehabilitation Instructor For The Blind (Entry),3333,1,Strikeable,3790,4425,4943,635,1153,10848,45480,59316
Rehabilitation Instructor For The Blind (Entry),3333,2,Strikeable,3964,4425,4943,461,979,11277,47568,59316
Rehabilitation Instructor For The Blind (Entry),3333,3,Strikeable,4155,4639,5169,484,1014,11748,49860,62028
Rehabilitation Instructor For The Blind (Entry),3333,4,Strikeable,4356,4851,5420,495,1064,12244,52272,65040
Rehabilitation Instructor For The Blind (Entry),3333,5,Strikeable,4555,5086,5695,531,1140,12735,54660,68340
Rehabilitation Instructor For The Blind (Entry),3333,6,Strikeable,4776,5345,5964,569,1188,13280,57312,71568
Rehabilitation Instructor For The Blind (Entry),3333,7,Strikeable,5019,5598,6245,579,1226,13879,60228,74940
Rehabilitation Instructor For The Blind (Entry),3333,8,Strikeable,5256,5861,6549,605,1293,14464,63072,78588
Rehabilitation Instructor For The Blind (Entry),3333,9,Strikeable,5503,6146,6549,643,1046,15073,66036,78588
Rehabilitation Instructor For The Blind (Entry),3333,10,Strikeable,5771,6146,6549,375,778,15734,69252,78588
Rehabilitation Therapist,6531,1,Strikeable,4356,4851,5420,495,1064,12244,52272,65040
Rehabilitation Therapist,6531,2,Strikeable,4555,5086,5695,531,1140,12735,54660,68340
Rehabilitation Therapist,6531,3,Strikeable,4776,5345,5964,569,1188,13280,57312,71568
Rehabilitation Therapist,6531,4,Strikeable,5019,5598,6245,579,1226,13879,60228,74940
Rehabilitation Therapist,6531,5,Strikeable,5256,5861,6549,605,1293,14464,63072,78588
Rehabilitation Therapist,6531,6,Strikeable,5503,6146,6866,643,1363,15073,66036,82392
Rehabilitation Therapist,6531,7,Strikeable,5771,6444,7206,673,1435,15734,69252,86472
Rehabilitation Therapist,6531,8,Strikeable,6051,6763,7562,712,1511,16424,72612,90744
Rehabilitation Therapist,6531,9,Strikeable,6350,7097,7562,747,1212,17162,76200,90744
Rehabilitation Therapist,6531,10,Strikeable,6664,7097,7562,433,898,17936,79968,90744
Research Analyst 1,1115,1,Strikeable,3483,4036,4498,553,1015,10091,41796,53976
Research Analyst 1,1115,2,Strikeable,3629,4036,4498,407,869,10451,43548,53976
Research Analyst 1,1115,3,Strikeable,3790,4222,4715,432,925,10848,45480,56580
Research Analyst 1,1115,4,Strikeable,3964,4425,4943,461,979,11277,47568,59316
Research Analyst 1,1115,5,Strikeable,4155,4639,5169,484,1014,11748,49860,62028
Research Analyst 1,1115,6,Strikeable,4356,4851,5420,495,1064,12244,52272,65040
Research Analyst 1,1115,7,Strikeable,4555,5086,5695,531,1140,12735,54660,68340
Research Analyst 1,1115,8,Strikeable,4776,5345,5964,569,1188,13280,57312,71568
Research Analyst 1,1115,9,Strikeable,5019,5598,5964,579,945,13879,60228,71568
Research Analyst 1,1115,10,Strikeable,5256,5598,5964,342,708,14464,63072,71568
Research Analyst 2,1116,1,Strikeable,4155,4639,5169,484,1014,11748,49860,62028
Research Analyst 2,1116,2,Strikeable,4356,4851,5420,495,1064,12244,52272,65040
Research Analyst 2,1116,3,Strikeable,4555,5086,5695,531,1140,12735,54660,68340
Research Analyst 2,1116,4,Strikeable,4776,5345,5964,569,1188,13280,57312,71568
Research Analyst 2,1116,5,Strikeable,5019,5598,6245,579,1226,13879,60228,74940
Research Analyst 2,1116,6,Strikeable,5256,5861,6549,605,1293,14464,63072,78588
Research Analyst 2,1116,7,Strikeable,5503,6146,6866,643,1363,15073,66036,82392
Research Analyst 2,1116,8,Strikeable,5771,6444,7206,673,1435,15734,69252,86472
Research Analyst 2,1116,9,Strikeable,6051,6763,7206,712,1155,16424,72612,86472
Research Analyst 2,1116,10,Strikeable,6350,6763,7206,413,856,17162,76200,86472
Research Analyst 3,1117,1,Strikeable,4776,5345,5964,569,1188,13280,57312,71568
Research Analyst 3,1117,2,Strikeable,5019,5598,6245,579,1226,13879,60228,74940
Research Analyst 3,1117,3,Strikeable,5256,5861,6549,605,1293,14464,63072,78588
Research Analyst 3,1117,4,Strikeable,5503,6146,6866,643,1363,15073,66036,82392
Research Analyst 3,1117,5,Strikeable,5771,6444,7206,673,1435,15734,69252,86472
Research Analyst 3,1117,6,Strikeable,6051,6763,7562,712,1511,16424,72612,90744
Research Analyst 3,1117,7,Strikeable,6350,7097,7923,747,1573,17162,76200,95076
Research Analyst 3,1117,8,Strikeable,6664,7436,8314,772,1650,17936,79968,99768
Research Analyst 3,1117,9,Strikeable,6982,7803,8314,821,1332,18721,83784,99768
Research Analyst 3,1117,10,Strikeable,7327,7803,8314,476,987,19571,87924,99768
Research Analyst 4,1118,1,Strikeable,5771,6444,7206,673,1435,15734,69252,86472
Research Analyst 4,1118,2,Strikeable,6051,6763,7562,712,1511,16424,72612,90744
Research Analyst 4,1118,3,Strikeable,6350,7097,7923,747,1573,17162,76200,95076
Research Analyst 4,1118,4,Strikeable,6664,7436,8314,772,1650,17936,79968,99768
Research Analyst 4,1118,5,Strikeable,6982,7803,8713,821,1731,18721,83784,104556
Research Analyst 4,1118,6,Strikeable,7327,8177,9143,850,1816,19571,87924,109716
Research Analyst 4,1118,7,Strikeable,7678,8581,9589,903,1911,20437,92136,115068
Research Analyst 4,1118,8,Strikeable,8057,8999,10065,942,2008,21372,96684,120780
Research Analyst 4,1118,9,Strikeable,8450,9447,10065,997,1615,22341,101400,120780
Research Analyst 4,1118,10,Strikeable,8870,9447,10065,577,1195,23377,106440,120780
Retirement Counselor 1,841,1,Strikeable,3629,4222,4715,593,1086,10451,43548,56580
Retirement Counselor 1,841,2,Strikeable,3790,4222,4715,432,925,10848,45480,56580
Retirement Counselor 1,841,3,Strikeable,3964,4425,4943,461,979,11277,47568,59316
Retirement Counselor 1,841,4,Strikeable,4155,4639,5169,484,1014,11748,49860,62028
Retirement Counselor 1,841,5,Strikeable,4356,4851,5420,495,1064,12244,52272,65040
Retirement Counselor 1,841,6,Strikeable,4555,5086,5695,531,1140,12735,54660,68340
Retirement Counselor 1,841,7,Strikeable,4776,5345,5964,569,1188,13280,57312,71568
Retirement Counselor 1,841,8,Strikeable,5019,5598,6245,579,1226,13879,60228,74940
Retirement Counselor 1,841,9,Strikeable,5256,5861,6245,605,989,14464,63072,74940
Retirement Counselor 1,841,10,Strikeable,5503,5861,6245,358,742,15073,66036,74940
Retirement Counselor 2,843,1,Strikeable,3964,4425,4943,461,979,11277,47568,59316
Retirement Counselor 2,843,2,Strikeable,4155,4639,5169,484,1014,11748,49860,62028
Retirement Counselor 2,843,3,Strikeable,4356,4851,5420,495,1064,12244,52272,65040
Retirement Counselor 2,843,4,Strikeable,4555,5086,5695,531,1140,12735,54660,68340
Retirement Counselor 2,843,5,Strikeable,4776,5345,5964,569,1188,13280,57312,71568
Retirement Counselor 2,843,6,Strikeable,5019,5598,6245,579,1226,13879,60228,74940
Retirement Counselor 2,843,7,Strikeable,5256,5861,6549,605,1293,14464,63072,78588
Retirement Counselor 2,843,8,Strikeable,5503,6146,6866,643,1363,15073,66036,82392
Retirement Counselor 2,843,9,Strikeable,5771,6444,6866,673,1095,15734,69252,82392
Retirement Counselor 2,843,10,Strikeable,6051,6444,6866,393,815,16424,72612,82392
Revenue Agent 1,5110,1,Strikeable,3218,3709,4118,491,900,9437,38616,49416
Revenue Agent 1,5110,2,Strikeable,3335,3709,4118,374,783,9726,40020,49416
Revenue Agent 1,5110,3,Strikeable,3483,3865,4301,382,818,10091,41796,51612
Revenue Agent 1,5110,4,Strikeable,3629,4036,4498,407,869,10451,43548,53976
Revenue Agent 1,5110,5,Strikeable,3790,4222,4715,432,925,10848,45480,56580
Revenue Agent 1,5110,6,Strikeable,3964,4425,4943,461,979,11277,47568,59316
Revenue Agent 1,5110,7,Strikeable,4155,4639,5169,484,1014,11748,49860,62028
Revenue Agent 1,5110,8,Strikeable,4356,4851,5420,495,1064,12244,52272,65040
Revenue Agent 1,5110,9,Strikeable,4555,5086,5420,531,865,12735,54660,65040
Revenue Agent 1,5110,10,Strikeable,4776,5086,5420,310,644,13280,57312,65040
Revenue Agent 2,5111,1,Strikeable,3483,3865,4301,382,818,10091,41796,51612
Revenue Agent 2,5111,2,Strikeable,3629,4036,4498,407,869,10451,43548,53976
Revenue Agent 2,5111,3,Strikeable,3790,4222,4715,432,925,10848,45480,56580
Revenue Agent 2,5111,4,Strikeable,3964,4425,4943,461,979,11277,47568,59316
Revenue Agent 2,5111,5,Strikeable,4155,4639,5169,484,1014,11748,49860,62028
Revenue Agent 2,5111,6,Strikeable,4356,4851,5420,495,1064,12244,52272,65040
Revenue Agent 2,5111,7,Strikeable,4555,5086,5695,531,1140,12735,54660,68340
Revenue Agent 2,5111,8,Strikeable,4776,5345,5964,569,1188,13280,57312,71568
Revenue Agent 2,5111,9,Strikeable,5019,5598,5964,579,945,13879,60228,71568
Revenue Agent 2,5111,10,Strikeable,5256,5598,5964,342,708,14464,63072,71568
Revenue Agent 3,5113,1,Strikeable,3790,4425,4943,635,1153,10848,45480,59316
Revenue Agent 3,5113,2,Strikeable,3964,4425,4943,461,979,11277,47568,59316
Revenue Agent 3,5113,3,Strikeable,4155,4639,5169,484,1014,11748,49860,62028
Revenue Agent 3,5113,4,Strikeable,4356,4851,5420,495,1064,12244,52272,65040
Revenue Agent 3,5113,5,Strikeable,4555,5086,5695,531,1140,12735,54660,68340
Revenue Agent 3,5113,6,Strikeable,4776,5345,5964,569,1188,13280,57312,71568
Revenue Agent 3,5113,7,Strikeable,5019,5598,6245,579,1226,13879,60228,74940
Revenue Agent 3,5113,8,Strikeable,5256,5861,6549,605,1293,14464,63072,78588
Revenue Agent 3,5113,9,Strikeable,5503,6146,6549,643,1046,15073,66036,78588
Revenue Agent 3,5113,10,Strikeable,5771,6146,6549,375,778,15734,69252,78588
Safety Specialist 1,1345,1,Strikeable,4155,4639,5169,484,1014,11748,49860,62028
Safety Specialist 1,1345,2,Strikeable,4356,4851,5420,495,1064,12244,52272,65040
Safety Specialist 1,1345,3,Strikeable,4555,5086,5695,531,1140,12735,54660,68340
Safety Specialist 1,1345,4,Strikeable,4776,5345,5964,569,1188,13280,57312,71568
Safety Specialist 1,1345,5,Strikeable,5019,5598,6245,579,1226,13879,60228,74940
Safety Specialist 1,1345,6,Strikeable,5256,5861,6549,605,1293,14464,63072,78588
Safety Specialist 1,1345,7,Strikeable,5503,6146,6866,643,1363,15073,66036,82392
Safety Specialist 1,1345,8,Strikeable,5771,6444,7206,673,1435,15734,69252,86472
Safety Specialist 1,1345,9,Strikeable,6051,6763,7206,712,1155,16424,72612,86472
Safety Specialist 1,1345,10,Strikeable,6350,6763,7206,413,856,17162,76200,86472
Safety Specialist 2,1346,1,Strikeable,5019,5598,6245,579,1226,13879,60228,74940
Safety Specialist 2,1346,2,Strikeable,5256,5861,6549,605,1293,14464,63072,78588
Safety Specialist 2,1346,3,Strikeable,5503,6146,6866,643,1363,15073,66036,82392
Safety Specialist 2,1346,4,Strikeable,5771,6444,7206,673,1435,15734,69252,86472
Safety Specialist 2,1346,5,Strikeable,6051,6763,7562,712,1511,16424,72612,90744
Safety Specialist 2,1346,6,Strikeable,6350,7097,7923,747,1573,17162,76200,95076
Safety Specialist 2,1346,7,Strikeable,6664,7436,8314,772,1650,17936,79968,99768
Safety Specialist 2,1346,8,Strikeable,6982,7803,8713,821,1731,18721,83784,104556
Safety Specialist 2,1346,9,Strikeable,7327,8177,8713,850,1386,19571,87924,104556
Safety Specialist 2,1346,10,Strikeable,7678,8177,8713,499,1035,20437,92136,104556
Scientific Instrument Technician,4339,1,Strikeable,3790,4425,4943,635,1153,10848,45480,59316
Scientific Instrument Technician,4339,2,Strikeable,3964,4425,4943,461,979,11277,47568,59316
Scientific Instrument Technician,4339,3,Strikeable,4155,4639,5169,484,1014,11748,49860,62028
Scientific Instrument Technician,4339,4,Strikeable,4356,4851,5420,495,1064,12244,52272,65040
Scientific Instrument Technician,4339,5,Strikeable,4555,5086,5695,531,1140,12735,54660,68340
Scientific Instrument Technician,4339,6,Strikeable,4776,5345,5964,569,1188,13280,57312,71568
Scientific Instrument Technician,4339,7,Strikeable,5019,5598,6245,579,1226,13879,60228,74940
Scientific Instrument Technician,4339,8,Strikeable,5256,5861,6549,605,1293,14464,63072,78588
Scientific Instrument Technician,4339,9,Strikeable,5503,6146,6549,643,1046,15073,66036,78588
Scientific Instrument Technician,4339,10,Strikeable,5771,6146,6549,375,778,15734,69252,78588
Seamster,9301,1,Strikeable,3005,3552,3952,547,947,8912,36060,47424
Seamster,9301,2,Strikeable,3095,3552,3952,457,857,9134,37140,47424
Seamster,9301,3,Strikeable,3218,3552,3952,334,734,9437,38616,47424
Seamster,9301,4,Strikeable,3335,3709,4118,374,783,9726,40020,49416
Seamster,9301,5,Strikeable,3483,3865,4301,382,818,10091,41796,51612
Seamster,9301,6,Strikeable,3629,4036,4498,407,869,10451,43548,53976
Seamster,9301,7,Strikeable,3790,4222,4715,432,925,10848,45480,56580
Seamster,9301,8,Strikeable,3964,4425,4943,461,979,11277,47568,59316
Seamster,9301,9,Strikeable,4155,4639,4943,484,788,11748,49860,59316
Seamster,9301,10,Strikeable,4356,4639,4943,283,587,12244,52272,59316
Securities Examiner,5671,1,Strikeable,5771,6444,7206,673,1435,15734,69252,86472
Securities Examiner,5671,2,Strikeable,6051,6763,7562,712,1511,16424,72612,90744
Securities Examiner,5671,3,Strikeable,6350,7097,7923,747,1573,17162,76200,95076
Securities Examiner,5671,4,Strikeable,6664,7436,8314,772,1650,17936,79968,99768
Securities Examiner,5671,5,Strikeable,6982,7803,8713,821,1731,18721,83784,104556
Securities Examiner,5671,6,Strikeable,7327,8177,9143,850,1816,19571,87924,109716
Securities Examiner,5671,7,Strikeable,7678,8581,9589,903,1911,20437,92136,115068
Securities Examiner,5671,8,Strikeable,8057,8999,10065,942,2008,21372,96684,120780
Securities Examiner,5671,9,Strikeable,8450,9447,10065,997,1615,22341,101400,120780
Securities Examiner,5671,10,Strikeable,8870,9447,10065,577,1195,23377,106440,120780
Shipping Point Inspector 1,5450,1,Strikeable,3005,3427,3784,422,779,8912,36060,45408
Shipping Point Inspector 1,5450,2,Strikeable,3095,3427,3784,332,689,9134,37140,45408
Shipping Point Inspector 1,5450,3,Strikeable,3218,3552,3952,334,734,9437,38616,47424
Shipping Point Inspector 1,5450,4,Strikeable,3335,3709,4118,374,783,9726,40020,49416
Shipping Point Inspector 1,5450,5,Strikeable,3483,3865,4301,382,818,10091,41796,51612
Shipping Point Inspector 1,5450,6,Strikeable,3629,4036,4498,407,869,10451,43548,53976
Shipping Point Inspector 1,5450,7,Strikeable,3790,4222,4715,432,925,10848,45480,56580
Shipping Point Inspector 1,5450,8,Strikeable,3964,4425,4943,461,979,11277,47568,59316
Shipping Point Inspector 1,5450,9,Strikeable,4155,4639,4943,484,788,11748,49860,59316
Shipping Point Inspector 1,5450,10,Strikeable,4356,4639,4943,283,587,12244,52272,59316
Shipping Point Inspector 2,5451,1,Strikeable,3218,3709,4118,491,900,9437,38616,49416
Shipping Point Inspector 2,5451,2,Strikeable,3335,3709,4118,374,783,9726,40020,49416
Shipping Point Inspector 2,5451,3,Strikeable,3483,3865,4301,382,818,10091,41796,51612
Shipping Point Inspector 2,5451,4,Strikeable,3629,4036,4498,407,869,10451,43548,53976
Shipping Point Inspector 2,5451,5,Strikeable,3790,4222,4715,432,925,10848,45480,56580
Shipping Point Inspector 2,5451,6,Strikeable,3964,4425,4943,461,979,11277,47568,59316
Shipping Point Inspector 2,5451,7,Strikeable,4155,4639,5169,484,1014,11748,49860,62028
Shipping Point Inspector 2,5451,8,Strikeable,4356,4851,5420,495,1064,12244,52272,65040
Shipping Point Inspector 2,5451,9,Strikeable,4555,5086,5420,531,865,12735,54660,65040
Shipping Point Inspector 2,5451,10,Strikeable,4776,5086,5420,310,644,13280,57312,65040
Sign Technician 1,4131,1,Strikeable,3483,4036,4498,553,1015,10091,41796,53976
Sign Technician 1,4131,2,Strikeable,3629,4036,4498,407,869,10451,43548,53976
Sign Technician 1,4131,3,Strikeable,3790,4222,4715,432,925,10848,45480,56580
Sign Technician 1,4131,4,Strikeable,3964,4425,4943,461,979,11277,47568,59316
Sign Technician 1,4131,5,Strikeable,4155,4639,5169,484,1014,11748,49860,62028
Sign Technician 1,4131,6,Strikeable,4356,4851,5420,495,1064,12244,52272,65040
Sign Technician 1,4131,7,Strikeable,4555,5086,5695,531,1140,12735,54660,68340
Sign Technician 1,4131,8,Strikeable,4776,5345,5964,569,1188,13280,57312,71568
Sign Technician 1,4131,9,Strikeable,5019,5598,5964,579,945,13879,60228,71568
Sign Technician 1,4131,10,Strikeable,5256,5598,5964,342,708,14464,63072,71568
Social Service Assistant,6609,1,Strikeable,3218,3709,4118,491,900,9437,38616,49416
Social Service Assistant,6609,2,Strikeable,3335,3709,4118,374,783,9726,40020,49416
Social Service Assistant,6609,3,Strikeable,3483,3865,4301,382,818,10091,41796,51612
Social Service Assistant,6609,4,Strikeable,3629,4036,4498,407,869,10451,43548,53976
Social Service Assistant,6609,5,Strikeable,3790,4222,4715,432,925,10848,45480,56580
Social Service Assistant,6609,6,Strikeable,3964,4425,4943,461,979,11277,47568,59316
Social Service Assistant,6609,7,Strikeable,4155,4639,5169,484,1014,11748,49860,62028
Social Service Assistant,6609,8,Strikeable,4356,4851,5420,495,1064,12244,52272,65040
Social Service Assistant,6609,9,Strikeable,4555,5086,5420,531,865,12735,54660,65040
Social Service Assistant,6609,10,Strikeable,4776,5086,5420,310,644,13280,57312,65040
Social Service Specialist 1,6613,1,Strikeable,4555,5086,5695,531,1140,12735,54660,68340
Social Service Specialist 1,6613,2,Strikeable,4776,5345,5964,569,1188,13280,57312,71568
Social Service Specialist 1,6613,3,Strikeable,5019,5598,6245,579,1226,13879,60228,74940
Social Service Specialist 1,6613,4,Strikeable,5256,5861,6549,605,1293,14464,63072,78588
Social Service Specialist 1,6613,5,Strikeable,5503,6146,6866,643,1363,15073,66036,82392
Social Service Specialist 1,6613,6,Strikeable,5771,6444,7206,673,1435,15734,69252,86472
Social Service Specialist 1,6613,7,Strikeable,6051,6763,7562,712,1511,16424,72612,90744
Social Service Specialist 1,6613,8,Strikeable,6350,7097,7923,747,1573,17162,76200,95076
Social Service Specialist 1,6613,9,Strikeable,6664,7436,7923,772,1259,17936,79968,95076
Social Service Specialist 1,6613,10,Strikeable,6982,7436,7923,454,941,18721,83784,95076
Social Services Specialist 2,6613,1,Strikeable,5019,5598,6245,579,1226,13879,60228,74940
Social Services Specialist 2,6613,2,Strikeable,5256,5861,6549,605,1293,14464,63072,78588
Social Services Specialist 2,6613,3,Strikeable,5503,6146,6866,643,1363,15073,66036,82392
Social Services Specialist 2,6613,4,Strikeable,5771,6444,7206,673,1435,15734,69252,86472
Social Services Specialist 2,6613,5,Strikeable,6051,6763,7562,712,1511,16424,72612,90744
Social Services Specialist 2,6613,6,Strikeable,6350,7097,7923,747,1573,17162,76200,95076
Social Services Specialist 2,6613,7,Strikeable,6664,7436,8314,772,1650,17936,79968,99768
Social Services Specialist 2,6613,8,Strikeable,6982,7803,8713,821,1731,18721,83784,104556
Social Services Specialist 2,6613,9,Strikeable,7327,8177,8713,850,1386,19571,87924,104556
Social Services Specialist 2,6613,10,Strikeable,7678,8177,8713,499,1035,20437,92136,104556
State Library Specialist 1,351,1,Strikeable,0,,,,,1500,0,
State Library Specialist 1,351,2,Strikeable,0,,,,,1500,0,
State Library Specialist 1,351,3,Strikeable,0,,,,,1500,0,
State Library Specialist 1,351,4,Strikeable,3005,3296,3652,291,647,8912,36060,43824
State Library Specialist 1,351,5,Strikeable,3095,3427,3784,332,689,9134,37140,45408
State Library Specialist 1,351,6,Strikeable,3218,3552,3952,334,734,9437,38616,47424
State Library Specialist 1,351,7,Strikeable,3335,3709,4118,374,783,9726,40020,49416
State Library Specialist 1,351,8,Strikeable,3483,3865,4301,382,818,10091,41796,51612
State Library Specialist 1,351,9,Strikeable,3629,4036,4301,407,672,10451,43548,51612
State Library Specialist 1,351,10,Strikeable,3790,4036,4301,246,511,10848,45480,51612
State Library Specialist 2,353,1,Strikeable,3335,3865,4301,530,966,9726,40020,51612
State Library Specialist 2,353,2,Strikeable,3483,3865,4301,382,818,10091,41796,51612
State Library Specialist 2,353,3,Strikeable,3629,4036,4498,407,869,10451,43548,53976
State Library Specialist 2,353,4,Strikeable,3790,4222,4715,432,925,10848,45480,56580
State Library Specialist 2,353,5,Strikeable,3964,4425,4943,461,979,11277,47568,59316
State Library Specialist 2,353,6,Strikeable,4155,4639,5169,484,1014,11748,49860,62028
State Library Specialist 2,353,7,Strikeable,4356,4851,5420,495,1064,12244,52272,65040
State Library Specialist 2,353,8,Strikeable,4555,5086,5695,531,1140,12735,54660,68340
State Library Specialist 2,353,9,Strikeable,4776,5345,5695,569,919,13280,57312,68340
State Library Specialist 2,353,10,Strikeable,5019,5345,5695,326,676,13879,60228,68340
State Procurement Analyst,770,1,Strikeable,5771,6444,7206,673,1435,15734,69252,86472
State Procurement Analyst,770,2,Strikeable,6051,6763,7562,712,1511,16424,72612,90744
State Procurement Analyst,770,3,Strikeable,6350,7097,7923,747,1573,17162,76200,95076
State Procurement Analyst,770,4,Strikeable,6664,7436,8314,772,1650,17936,79968,99768
State Procurement Analyst,770,5,Strikeable,6982,7803,8713,821,1731,18721,83784,104556
State Procurement Analyst,770,6,Strikeable,7327,8177,9143,850,1816,19571,87924,109716
State Procurement Analyst,770,7,Strikeable,7678,8581,9589,903,1911,20437,92136,115068
State Procurement Analyst,770,8,Strikeable,8057,8999,10065,942,2008,21372,96684,120780
State Procurement Analyst,770,9,Strikeable,8450,9447,10065,997,1615,22341,101400,120780
State Procurement Analyst,770,10,Strikeable,8870,9447,10065,577,1195,23377,106440,120780
Student Office Worker,100,1,Strikeable,0,4301,4301,4301,4301,1500,0,51612
Student Office Worker,100,2,Strikeable,0,4301,4301,4301,4301,1500,0,51612
Student Office Worker,100,3,Strikeable,0,4301,4301,4301,4301,1500,0,51612
Student Office Worker,100,4,Strikeable,0,4301,4301,4301,4301,1500,0,51612
Student Office Worker,100,5,Strikeable,0,4301,4301,4301,4301,1500,0,51612
Student Office Worker,100,6,Strikeable,0,4301,4301,4301,4301,1500,0,51612
Student Office Worker,100,7,Strikeable,0,4301,4301,4301,4301,1500,0,51612
Student Office Worker,100,8,Strikeable,0,4301,4301,4301,4301,1500,0,51612
Student Office Worker,100,9,Strikeable,3005,4301,4301,1296,1296,8912,36060,51612
Student Office Worker,100,10,Strikeable,3095,4301,4301,1206,1206,9134,37140,51612
Supply Specialist 1,758,1,Strikeable,0,,,,,1500,0,
Supply Specialist 1,758,2,Strikeable,3005,3427,3784,422,779,8912,36060,45408
Supply Specialist 1,758,3,Strikeable,3095,3427,3784,332,689,9134,37140,45408
Supply Specialist 1,758,4,Strikeable,3218,3552,3952,334,734,9437,38616,47424
Supply Specialist 1,758,5,Strikeable,3335,3709,4118,374,783,9726,40020,49416
Supply Specialist 1,758,6,Strikeable,3483,3865,4301,382,818,10091,41796,51612
Supply Specialist 1,758,7,Strikeable,3629,4036,4498,407,869,10451,43548,53976
Supply Specialist 1,758,8,Strikeable,3790,4222,4715,432,925,10848,45480,56580
Supply Specialist 1,758,9,Strikeable,3964,4425,4715,461,751,11277,47568,56580
Supply Specialist 1,758,10,Strikeable,4155,4425,4715,270,560,11748,49860,56580
Supply Specialist 2,759,1,Strikeable,3629,4222,4715,593,1086,10451,43548,56580
Supply Specialist 2,759,2,Strikeable,3790,4222,4715,432,925,10848,45480,56580
Supply Specialist 2,759,3,Strikeable,3964,4425,4943,461,979,11277,47568,59316
Supply Specialist 2,759,4,Strikeable,4155,4639,5169,484,1014,11748,49860,62028
Supply Specialist 2,759,5,Strikeable,4356,4851,5420,495,1064,12244,52272,65040
Supply Specialist 2,759,6,Strikeable,4555,5086,5695,531,1140,12735,54660,68340
Supply Specialist 2,759,7,Strikeable,4776,5345,5964,569,1188,13280,57312,71568
Supply Specialist 2,759,8,Strikeable,5019,5598,6245,579,1226,13879,60228,74940
Supply Specialist 2,759,9,Strikeable,5256,5861,6245,605,989,14464,63072,74940
Supply Specialist 2,759,10,Strikeable,5503,5861,6245,358,742,15073,66036,74940
Tax Auditor 1,5631,1,Strikeable,4555,5086,5695,531,1140,12735,54660,68340
Tax Auditor 1,5631,2,Strikeable,4776,5345,5964,569,1188,13280,57312,71568
Tax Auditor 1,5631,3,Strikeable,5019,5598,6245,579,1226,13879,60228,74940
Tax Auditor 1,5631,4,Strikeable,5256,5861,6549,605,1293,14464,63072,78588
Tax Auditor 1,5631,5,Strikeable,5503,6146,6866,643,1363,15073,66036,82392
Tax Auditor 1,5631,6,Strikeable,5771,6444,7206,673,1435,15734,69252,86472
Tax Auditor 1,5631,7,Strikeable,6051,6763,7562,712,1511,16424,72612,90744
Tax Auditor 1,5631,8,Strikeable,6350,7097,7923,747,1573,17162,76200,95076
Tax Auditor 1,5631,9,Strikeable,6664,7436,7923,772,1259,17936,79968,95076
Tax Auditor 1,5631,10,Strikeable,6982,7436,7923,454,941,18721,83784,95076
Tax Auditor 2,5633,1,Strikeable,5256,5861,6549,605,1293,14464,63072,78588
Tax Auditor 2,5633,2,Strikeable,5503,6146,6866,643,1363,15073,66036,82392
Tax Auditor 2,5633,3,Strikeable,5771,6444,7206,673,1435,15734,69252,86472
Tax Auditor 2,5633,4,Strikeable,6051,6763,7562,712,1511,16424,72612,90744
Tax Auditor 2,5633,5,Strikeable,6350,7097,7923,747,1573,17162,76200,95076
Tax Auditor 2,5633,6,Strikeable,6664,7436,8314,772,1650,17936,79968,99768
Tax Auditor 2,5633,7,Strikeable,6982,7803,8713,821,1731,18721,83784,104556
Tax Auditor 2,5633,8,Strikeable,7327,8177,9143,850,1816,19571,87924,109716
Tax Auditor 2,5633,9,Strikeable,7678,8581,9143,903,1465,20437,92136,109716
Tax Auditor 2,5633,10,Strikeable,8057,8581,9143,524,1086,21372,96684,109716
Tax Auditor/Entry,5630,1,Strikeable,3629,4222,4715,593,1086,10451,43548,56580
Tax Auditor/Entry,5630,2,Strikeable,3790,4222,4715,432,925,10848,45480,56580
Tax Auditor/Entry,5630,3,Strikeable,3964,4425,4943,461,979,11277,47568,59316
Tax Auditor/Entry,5630,4,Strikeable,4155,4639,5169,484,1014,11748,49860,62028
Tax Auditor/Entry,5630,5,Strikeable,4356,4851,5420,495,1064,12244,52272,65040
Tax Auditor/Entry,5630,6,Strikeable,4555,5086,5695,531,1140,12735,54660,68340
Tax Auditor/Entry,5630,7,Strikeable,4776,5345,5964,569,1188,13280,57312,71568
Tax Auditor/Entry,5630,8,Strikeable,5019,5598,6245,579,1226,13879,60228,74940
Tax Auditor/Entry,5630,9,Strikeable,5256,5861,6245,605,989,14464,63072,74940
Tax Auditor/Entry,5630,10,Strikeable,5503,5861,6245,358,742,15073,66036,74940
Teaching Assistant,3303,1,Strikeable,3005,3427,3784,422,779,8912,36060,45408
Teaching Assistant,3303,2,Strikeable,3095,3427,3784,332,689,9134,37140,45408
Teaching Assistant,3303,3,Strikeable,3218,3552,3952,334,734,9437,38616,47424
Teaching Assistant,3303,4,Strikeable,3335,3709,4118,374,783,9726,40020,49416
Teaching Assistant,3303,5,Strikeable,3483,3865,4301,382,818,10091,41796,51612
Teaching Assistant,3303,6,Strikeable,3629,4036,4498,407,869,10451,43548,53976
Teaching Assistant,3303,7,Strikeable,3790,4222,4715,432,925,10848,45480,56580
Teaching Assistant,3303,8,Strikeable,3964,4425,4943,461,979,11277,47568,59316
Teaching Assistant,3303,9,Strikeable,4155,4639,4943,484,788,11748,49860,59316
Teaching Assistant,3303,10,Strikeable,4356,4639,4943,283,587,12244,52272,59316
Traffic Survey Interviewer,1105,1,Strikeable,0,,,,,1500,0,
Traffic Survey Interviewer,1105,2,Strikeable,0,,,,,1500,0,
Traffic Survey Interviewer,1105,3,Strikeable,0,,,,,1500,0,
Traffic Survey Interviewer,1105,4,Strikeable,0,,,,,1500,0,
Traffic Survey Interviewer,1105,5,Strikeable,0,,,,,1500,0,
Traffic Survey Interviewer,1105,6,Strikeable,0,,,,,1500,0,
Traffic Survey Interviewer,1105,7,Strikeable,0,,,,,1500,0,
Traffic Survey Interviewer,1105,8,Strikeable,3005,3427,3652,422,647,8912,36060,43824
Traffic Survey Interviewer,1105,9,Strikeable,3095,3427,3652,332,557,9134,37140,43824
Traffic Survey Interviewer,1105,10,Strikeable,3218,3427,3652,209,434,9437,38616,43824
Training & Development Specialist 1,1338,1,Strikeable,4155,4639,5169,484,1014,11748,49860,62028
Training & Development Specialist 1,1338,2,Strikeable,4356,4851,5420,495,1064,12244,52272,65040
Training & Development Specialist 1,1338,3,Strikeable,4555,5086,5695,531,1140,12735,54660,68340
Training & Development Specialist 1,1338,4,Strikeable,4776,5345,5964,569,1188,13280,57312,71568
Training & Development Specialist 1,1338,5,Strikeable,5019,5598,6245,579,1226,13879,60228,74940
Training & Development Specialist 1,1338,6,Strikeable,5256,5861,6549,605,1293,14464,63072,78588
Training & Development Specialist 1,1338,7,Strikeable,5503,6146,6866,643,1363,15073,66036,82392
Training & Development Specialist 1,1338,8,Strikeable,5771,6444,7206,673,1435,15734,69252,86472
Training & Development Specialist 1,1338,9,Strikeable,6051,6763,7206,712,1155,16424,72612,86472
Training & Development Specialist 1,1338,10,Strikeable,6350,6763,7206,413,856,17162,76200,86472
Training & Development Specialist 2,1339,1,Strikeable,5019,5598,6245,579,1226,13879,60228,74940
Training & Development Specialist 2,1339,2,Strikeable,5256,5861,6549,605,1293,14464,63072,78588
Training & Development Specialist 2,1339,3,Strikeable,5503,6146,6866,643,1363,15073,66036,82392
Training & Development Specialist 2,1339,4,Strikeable,5771,6444,7206,673,1435,15734,69252,86472
Training & Development Specialist 2,1339,5,Strikeable,6051,6763,7562,712,1511,16424,72612,90744
Training & Development Specialist 2,1339,6,Strikeable,6350,7097,7923,747,1573,17162,76200,95076
Training & Development Specialist 2,1339,7,Strikeable,6664,7436,8314,772,1650,17936,79968,99768
Training & Development Specialist 2,1339,8,Strikeable,6982,7803,8713,821,1731,18721,83784,104556
Training & Development Specialist 2,1339,9,Strikeable,7327,8177,8713,850,1386,19571,87924,104556
Training & Development Specialist 2,1339,10,Strikeable,7678,8177,8713,499,1035,20437,92136,104556
Transportation Maintenance Coordinator 1,4161,1,Strikeable,3790,4425,4943,635,1153,10848,45480,59316
Transportation Maintenance Coordinator 1,4161,2,Strikeable,3964,4425,4943,461,979,11277,47568,59316
Transportation Maintenance Coordinator 1,4161,3,Strikeable,4155,4639,5169,484,1014,11748,49860,62028
Transportation Maintenance Coordinator 1,4161,4,Strikeable,4356,4851,5420,495,1064,12244,52272,65040
Transportation Maintenance Coordinator 1,4161,5,Strikeable,4555,5086,5695,531,1140,12735,54660,68340
Transportation Maintenance Coordinator 1,4161,6,Strikeable,4776,5345,5964,569,1188,13280,57312,71568
Transportation Maintenance Coordinator 1,4161,7,Strikeable,5019,5598,6245,579,1226,13879,60228,74940
Transportation Maintenance Coordinator 1,4161,8,Strikeable,5256,5861,6549,605,1293,14464,63072,78588
Transportation Maintenance Coordinator 1,4161,9,Strikeable,5503,6146,6549,643,1046,15073,66036,78588
Transportation Maintenance Coordinator 1,4161,10,Strikeable,5771,6146,6549,375,778,15734,69252,78588
Transportation Maintenance Coordinator 2,4163,1,Strikeable,3964,4425,4943,461,979,11277,47568,59316
Transportation Maintenance Coordinator 2,4163,2,Strikeable,4155,4639,5169,484,1014,11748,49860,62028
Transportation Maintenance Coordinator 2,4163,3,Strikeable,4356,4851,5420,495,1064,12244,52272,65040
Transportation Maintenance Coordinator 2,4163,4,Strikeable,4555,5086,5695,531,1140,12735,54660,68340
Transportation Maintenance Coordinator 2,4163,5,Strikeable,4776,5345,5964,569,1188,13280,57312,71568
Transportation Maintenance Coordinator 2,4163,6,Strikeable,5019,5598,6245,579,1226,13879,60228,74940
Transportation Maintenance Coordinator 2,4163,7,Strikeable,5256,5861,6549,605,1293,14464,63072,78588
Transportation Maintenance Coordinator 2,4163,8,Strikeable,5503,6146,6866,643,1363,15073,66036,82392
Transportation Maintenance Coordinator 2,4163,9,Strikeable,5771,6444,6866,673,1095,15734,69252,82392
Transportation Maintenance Coordinator 2,4163,10,Strikeable,6051,6444,6866,393,815,16424,72612,82392
Transportation Maintenance Specialist 1,4151,1,Strikeable,3218,3709,4118,491,900,9437,38616,49416
Transportation Maintenance Specialist 1,4151,2,Strikeable,3335,3709,4118,374,783,9726,40020,49416
Transportation Maintenance Specialist 1,4151,3,Strikeable,3483,3865,4301,382,818,10091,41796,51612
Transportation Maintenance Specialist 1,4151,4,Strikeable,3629,4036,4498,407,869,10451,43548,53976
Transportation Maintenance Specialist 1,4151,5,Strikeable,3790,4222,4715,432,925,10848,45480,56580
Transportation Maintenance Specialist 1,4151,6,Strikeable,3964,4425,4943,461,979,11277,47568,59316
Transportation Maintenance Specialist 1,4151,7,Strikeable,4155,4639,5169,484,1014,11748,49860,62028
Transportation Maintenance Specialist 1,4151,8,Strikeable,4356,4851,5420,495,1064,12244,52272,65040
Transportation Maintenance Specialist 1,4151,9,Strikeable,4555,5086,5420,531,865,12735,54660,65040
Transportation Maintenance Specialist 1,4151,10,Strikeable,4776,5086,5420,310,644,13280,57312,65040
Transportation Maintenance Specialist 2,4153,1,Strikeable,3483,4036,4498,553,1015,10091,41796,53976
Transportation Maintenance Specialist 2,4153,2,Strikeable,3629,4036,4498,407,869,10451,43548,53976
Transportation Maintenance Specialist 2,4153,3,Strikeable,3790,4222,4715,432,925,10848,45480,56580
Transportation Maintenance Specialist 2,4153,4,Strikeable,3964,4425,4943,461,979,11277,47568,59316
Transportation Maintenance Specialist 2,4153,5,Strikeable,4155,4639,5169,484,1014,11748,49860,62028
Transportation Maintenance Specialist 2,4153,6,Strikeable,4356,4851,5420,495,1064,12244,52272,65040
Transportation Maintenance Specialist 2,4153,7,Strikeable,4555,5086,5695,531,1140,12735,54660,68340
Transportation Maintenance Specialist 2,4153,8,Strikeable,4776,5345,5964,569,1188,13280,57312,71568
Transportation Maintenance Specialist 2,4153,9,Strikeable,5019,5598,5964,579,945,13879,60228,71568
Transportation Maintenance Specialist 2,4153,10,Strikeable,5256,5598,5964,342,708,14464,63072,71568
Transportation Maintenance Specialist Entry,4150,1,Strikeable,0,,,,,1500,0,
Transportation Maintenance Specialist Entry,4150,2,Strikeable,0,,,,,1500,0,
Transportation Maintenance Specialist Entry,4150,3,Strikeable,0,,,,,1500,0,
Transportation Maintenance Specialist Entry,4150,4,Strikeable,0,,,,,1500,0,
Transportation Maintenance Specialist Entry,4150,5,Strikeable,3335,3865,4301,530,966,9726,40020,51612
Transportation Maintenance Specialist Entry,4150,6,Strikeable,3483,3865,4301,382,818,10091,41796,51612
Transportation Maintenance Specialist Entry,4150,7,Strikeable,3629,4036,4498,407,869,10451,43548,53976
Transportation Maintenance Specialist Entry,4150,8,Strikeable,3790,4222,4715,432,925,10848,45480,56580
Transportation Maintenance Specialist Entry,4150,9,Strikeable,3964,4425,4715,461,751,11277,47568,56580
Transportation Maintenance Specialist Entry,4150,10,Strikeable,4155,4425,4715,270,560,11748,49860,56580
Transportation Services Office Leader,333,1,Strikeable,3790,4425,4943,635,1153,10848,45480,59316
Transportation Services Office Leader,333,2,Strikeable,3964,4425,4943,461,979,11277,47568,59316
Transportation Services Office Leader,333,3,Strikeable,4155,4639,5169,484,1014,11748,49860,62028
Transportation Services Office Leader,333,4,Strikeable,4356,4851,5420,495,1064,12244,52272,65040
Transportation Services Office Leader,333,5,Strikeable,4555,5086,5695,531,1140,12735,54660,68340
Transportation Services Office Leader,333,6,Strikeable,4776,5345,5964,569,1188,13280,57312,71568
Transportation Services Office Leader,333,7,Strikeable,5019,5598,6245,579,1226,13879,60228,74940
Transportation Services Office Leader,333,8,Strikeable,5256,5861,6549,605,1293,14464,63072,78588
Transportation Services Office Leader,333,9,Strikeable,5503,6146,6549,643,1046,15073,66036,78588
Transportation Services Office Leader,333,10,Strikeable,5771,6146,6549,375,778,15734,69252,78588
Transportation Services Representative 1,331,1,Strikeable,3218,3709,4118,491,900,9437,38616,49416
Transportation Services Representative 1,331,2,Strikeable,3335,3709,4118,374,783,9726,40020,49416
Transportation Services Representative 1,331,3,Strikeable,3483,3865,4301,382,818,10091,41796,51612
Transportation Services Representative 1,331,4,Strikeable,3629,4036,4498,407,869,10451,43548,53976
Transportation Services Representative 1,331,5,Strikeable,3790,4222,4715,432,925,10848,45480,56580
Transportation Services Representative 1,331,6,Strikeable,3964,4425,4943,461,979,11277,47568,59316
Transportation Services Representative 1,331,7,Strikeable,4155,4639,5169,484,1014,11748,49860,62028
Transportation Services Representative 1,331,8,Strikeable,4356,4851,5420,495,1064,12244,52272,65040
Transportation Services Representative 1,331,9,Strikeable,4555,5086,5420,531,865,12735,54660,65040
Transportation Services Representative 1,331,10,Strikeable,4776,5086,5420,310,644,13280,57312,65040
Transportation Services Representative 2,333,1,Strikeable,3483,4036,4498,553,1015,10091,41796,53976
Transportation Services Representative 2,333,2,Strikeable,3629,4036,4498,407,869,10451,43548,53976
Transportation Services Representative 2,333,3,Strikeable,3790,4222,4715,432,925,10848,45480,56580
Transportation Services Representative 2,333,4,Strikeable,3964,4425,4943,461,979,11277,47568,59316
Transportation Services Representative 2,333,5,Strikeable,4155,4639,5169,484,1014,11748,49860,62028
Transportation Services Representative 2,333,6,Strikeable,4356,4851,5420,495,1064,12244,52272,65040
Transportation Services Representative 2,333,7,Strikeable,4555,5086,5695,531,1140,12735,54660,68340
Transportation Services Representative 2,333,8,Strikeable,4776,5345,5964,569,1188,13280,57312,71568
Transportation Services Representative 2,333,9,Strikeable,5019,5598,5964,579,945,13879,60228,71568
Transportation Services Representative 2,333,10,Strikeable,5256,5598,5964,342,708,14464,63072,71568
Transportation Telecommunications Specialist 1,4166,1,Strikeable,3629,4222,4715,593,1086,10451,43548,56580
Transportation Telecommunications Specialist 1,4166,2,Strikeable,3790,4222,4715,432,925,10848,45480,56580
Transportation Telecommunications Specialist 1,4166,3,Strikeable,3964,4425,4943,461,979,11277,47568,59316
Transportation Telecommunications Specialist 1,4166,4,Strikeable,4155,4639,5169,484,1014,11748,49860,62028
Transportation Telecommunications Specialist 1,4166,5,Strikeable,4356,4851,5420,495,1064,12244,52272,65040
Transportation Telecommunications Specialist 1,4166,6,Strikeable,4555,5086,5695,531,1140,12735,54660,68340
Transportation Telecommunications Specialist 1,4166,7,Strikeable,4776,5345,5964,569,1188,13280,57312,71568
Transportation Telecommunications Specialist 1,4166,8,Strikeable,5019,5598,6245,579,1226,13879,60228,74940
Transportation Telecommunications Specialist 1,4166,9,Strikeable,5256,5861,6245,605,989,14464,63072,74940
Transportation Telecommunications Specialist 1,4166,10,Strikeable,5503,5861,6245,358,742,15073,66036,74940
Transportation Telecommunications Specialist 2,4167,1,Strikeable,3964,4425,4943,461,979,11277,47568,59316
Transportation Telecommunications Specialist 2,4167,2,Strikeable,4155,4639,5169,484,1014,11748,49860,62028
Transportation Telecommunications Specialist 2,4167,3,Strikeable,4356,4851,5420,495,1064,12244,52272,65040
Transportation Telecommunications Specialist 2,4167,4,Strikeable,4555,5086,5695,531,1140,12735,54660,68340
Transportation Telecommunications Specialist 2,4167,5,Strikeable,4776,5345,5964,569,1188,13280,57312,71568
Transportation Telecommunications Specialist 2,4167,6,Strikeable,5019,5598,6245,579,1226,13879,60228,74940
Transportation Telecommunications Specialist 2,4167,7,Strikeable,5256,5861,6549,605,1293,14464,63072,78588
Transportation Telecommunications Specialist 2,4167,8,Strikeable,5503,6146,6866,643,1363,15073,66036,82392
Transportation Telecommunications Specialist 2,4167,9,Strikeable,5771,6444,6866,673,1095,15734,69252,82392
Transportation Telecommunications Specialist 2,4167,10,Strikeable,6051,6444,6866,393,815,16424,72612,82392
Transporter,4403,1,Strikeable,0,,,,,1500,0,
Transporter,4403,2,Strikeable,0,,,,,1500,0,
Transporter,4403,3,Strikeable,0,,,,,1500,0,
Transporter,4403,4,Strikeable,0,,,,,1500,0,
Transporter,4403,5,Strikeable,3005,3427,3784,422,779,8912,36060,45408
Transporter,4403,6,Strikeable,3095,3427,3784,332,689,9134,37140,45408
Transporter,4403,7,Strikeable,3218,3552,3952,334,734,9437,38616,47424
Transporter,4403,8,Strikeable,3335,3709,4118,374,783,9726,40020,49416
Transporter,4403,9,Strikeable,3483,3865,4118,382,635,10091,41796,49416
Transporter,4403,10,Strikeable,3629,3865,4118,236,489,10451,43548,49416
Transporting Mental Health Aide,6101,1,Strikeable,3218,3865,4301,647,1083,9437,38616,51612
Transporting Mental Health Aide,6101,2,Strikeable,3335,3865,4301,530,966,9726,40020,51612
Transporting Mental Health Aide,6101,3,Strikeable,3483,3865,4301,382,818,10091,41796,51612
Transporting Mental Health Aide,6101,4,Strikeable,3629,4036,4498,407,869,10451,43548,53976
Transporting Mental Health Aide,6101,5,Strikeable,3790,4222,4715,432,925,10848,45480,56580
Transporting Mental Health Aide,6101,6,Strikeable,3964,4425,4943,461,979,11277,47568,59316
Transporting Mental Health Aide,6101,7,Strikeable,4155,4639,5169,484,1014,11748,49860,62028
Transporting Mental Health Aide,6101,8,Strikeable,4356,4851,5420,495,1064,12244,52272,65040
Transporting Mental Health Aide,6101,9,Strikeable,4555,5086,5420,531,865,12735,54660,65040
Transporting Mental Health Aide,6101,10,Strikeable,4776,5086,5420,310,644,13280,57312,65040
Truck Driver 1,4401,1,Strikeable,3218,3709,4118,491,900,9437,38616,49416
Truck Driver 1,4401,2,Strikeable,3335,3709,4118,374,783,9726,40020,49416
Truck Driver 1,4401,3,Strikeable,3483,3865,4301,382,818,10091,41796,51612
Truck Driver 1,4401,4,Strikeable,3629,4036,4498,407,869,10451,43548,53976
Truck Driver 1,4401,5,Strikeable,3790,4222,4715,432,925,10848,45480,56580
Truck Driver 1,4401,6,Strikeable,3964,4425,4943,461,979,11277,47568,59316
Truck Driver 1,4401,7,Strikeable,4155,4639,5169,484,1014,11748,49860,62028
Truck Driver 1,4401,8,Strikeable,4356,4851,5420,495,1064,12244,52272,65040
Truck Driver 1,4401,9,Strikeable,4555,5086,5420,531,865,12735,54660,65040
Truck Driver 1,4401,10,Strikeable,4776,5086,5420,310,644,13280,57312,65040
Truck Driver 2,4403,1,Strikeable,3629,4222,4715,593,1086,10451,43548,56580
Truck Driver 2,4403,2,Strikeable,3790,4222,4715,432,925,10848,45480,56580
Truck Driver 2,4403,3,Strikeable,3964,4425,4943,461,979,11277,47568,59316
Truck Driver 2,4403,4,Strikeable,4155,4639,5169,484,1014,11748,49860,62028
Truck Driver 2,4403,5,Strikeable,4356,4851,5420,495,1064,12244,52272,65040
Truck Driver 2,4403,6,Strikeable,4555,5086,5695,531,1140,12735,54660,68340
Truck Driver 2,4403,7,Strikeable,4776,5345,5964,569,1188,13280,57312,71568
Truck Driver 2,4403,8,Strikeable,5019,5598,6245,579,1226,13879,60228,74940
Truck Driver 2,4403,9,Strikeable,5256,5861,6245,605,989,14464,63072,74940
Truck Driver 2,4403,10,Strikeable,5503,5861,6245,358,742,15073,66036,74940
Veterans Service Officer,799,1,Strikeable,4155,4639,5169,484,1014,11748,49860,62028
Veterans Service Officer,799,2,Strikeable,4356,4851,5420,495,1064,12244,52272,65040
Veterans Service Officer,799,3,Strikeable,4555,5086,5695,531,1140,12735,54660,68340
Veterans Service Officer,799,4,Strikeable,4776,5345,5964,569,1188,13280,57312,71568
Veterans Service Officer,799,5,Strikeable,5019,5598,6245,579,1226,13879,60228,74940
Veterans Service Officer,799,6,Strikeable,5256,5861,6549,605,1293,14464,63072,78588
Veterans Service Officer,799,7,Strikeable,5503,6146,6866,643,1363,15073,66036,82392
Veterans Service Officer,799,8,Strikeable,5771,6444,7206,673,1435,15734,69252,86472
Veterans Service Officer,799,9,Strikeable,6051,6763,7206,712,1155,16424,72612,86472
Veterans Service Officer,799,10,Strikeable,6350,6763,7206,413,856,17162,76200,86472
Veterans Trust Officer,784,1,Strikeable,4155,4639,5169,484,1014,11748,49860,62028
Veterans Trust Officer,784,2,Strikeable,4356,4851,5420,495,1064,12244,52272,65040
Veterans Trust Officer,784,3,Strikeable,4555,5086,5695,531,1140,12735,54660,68340
Veterans Trust Officer,784,4,Strikeable,4776,5345,5964,569,1188,13280,57312,71568
Veterans Trust Officer,784,5,Strikeable,5019,5598,6245,579,1226,13879,60228,74940
Veterans Trust Officer,784,6,Strikeable,5256,5861,6549,605,1293,14464,63072,78588
Veterans Trust Officer,784,7,Strikeable,5503,6146,6866,643,1363,15073,66036,82392
Veterans Trust Officer,784,8,Strikeable,5771,6444,7206,673,1435,15734,69252,86472
Veterans Trust Officer,784,9,Strikeable,6051,6763,7206,712,1155,16424,72612,86472
Veterans Trust Officer,784,10,Strikeable,6350,6763,7206,413,856,17162,76200,86472
Video Producer,3176,1,Strikeable,5256,5861,6549,605,1293,14464,63072,78588
Video Producer,3176,2,Strikeable,5503,6146,6866,643,1363,15073,66036,82392
Video Producer,3176,3,Strikeable,5771,6444,7206,673,1435,15734,69252,86472
Video Producer,3176,4,Strikeable,6051,6763,7562,712,1511,16424,72612,90744
Video Producer,3176,5,Strikeable,6350,7097,7923,747,1573,17162,76200,95076
Video Producer,3176,6,Strikeable,6664,7436,8314,772,1650,17936,79968,99768
Video Producer,3176,7,Strikeable,6982,7803,8713,821,1731,18721,83784,104556
Video Producer,3176,8,Strikeable,7327,8177,9143,850,1816,19571,87924,109716
Video Producer,3176,9,Strikeable,7678,8581,9143,903,1465,20437,92136,109716
Video Producer,3176,10,Strikeable,8057,8581,9143,524,1086,21372,96684,109716
Vocational Rehabilitation Counselor,6647,1,Strikeable,4555,5086,5695,531,1140,12735,54660,68340
Vocational Rehabilitation Counselor,6647,2,Strikeable,4776,5345,5964,569,1188,13280,57312,71568
Vocational Rehabilitation Counselor,6647,3,Strikeable,5019,5598,6245,579,1226,13879,60228,74940
Vocational Rehabilitation Counselor,6647,4,Strikeable,5256,5861,6549,605,1293,14464,63072,78588
Vocational Rehabilitation Counselor,6647,5,Strikeable,5503,6146,6866,643,1363,15073,66036,82392
Vocational Rehabilitation Counselor,6647,6,Strikeable,5771,6444,7206,673,1435,15734,69252,86472
Vocational Rehabilitation Counselor,6647,7,Strikeable,6051,6763,7562,712,1511,16424,72612,90744
Vocational Rehabilitation Counselor,6647,8,Strikeable,6350,7097,7923,747,1573,17162,76200,95076
Vocational Rehabilitation Counselor,6647,9,Strikeable,6664,7436,7923,772,1259,17936,79968,95076
Vocational Rehabilitation Counselor,6647,10,Strikeable,6982,7436,7923,454,941,18721,83784,95076
Vocational Rehabilitation Counselor Entry,6646,1,Strikeable,3629,4036,4498,407,869,10451,43548,53976
Vocational Rehabilitation Counselor Entry,6646,2,Strikeable,3790,4222,4715,432,925,10848,45480,56580
Vocational Rehabilitation Counselor Entry,6646,3,Strikeable,3964,4425,4943,461,979,11277,47568,59316
Vocational Rehabilitation Counselor Entry,6646,4,Strikeable,4155,4639,5169,484,1014,11748,49860,62028
Vocational Rehabilitation Counselor Entry,6646,5,Strikeable,4356,4851,5420,495,1064,12244,52272,65040
Vocational Rehabilitation Counselor Entry,6646,6,Strikeable,4555,5086,5695,531,1140,12735,54660,68340
Vocational Rehabilitation Counselor Entry,6646,7,Strikeable,4776,5345,5964,569,1188,13280,57312,71568
Vocational Rehabilitation Counselor Entry,6646,8,Strikeable,5019,5598,6245,579,1226,13879,60228,74940
Vocational Rehabilitation Counselor Entry,6646,9,Strikeable,5256,5861,6245,605,989,14464,63072,74940
Vocational Rehabilitation Counselor Entry,6646,10,Strikeable,5503,5861,6245,358,742,15073,66036,74940
Vocational Rehabilitation Specialist,6648,1,Strikeable,4776,5345,5964,569,1188,13280,57312,71568
Vocational Rehabilitation Specialist,6648,2,Strikeable,5019,5598,6245,579,1226,13879,60228,74940
Vocational Rehabilitation Specialist,6648,3,Strikeable,5256,5861,6549,605,1293,14464,63072,78588
Vocational Rehabilitation Specialist,6648,4,Strikeable,5503,6146,6866,643,1363,15073,66036,82392
Vocational Rehabilitation Specialist,6648,5,Strikeable,5771,6444,7206,673,1435,15734,69252,86472
Vocational Rehabilitation Specialist,6648,6,Strikeable,6051,6763,7562,712,1511,16424,72612,90744
Vocational Rehabilitation Specialist,6648,7,Strikeable,6350,7097,7923,747,1573,17162,76200,95076
Vocational Rehabilitation Specialist,6648,8,Strikeable,6664,7436,8314,772,1650,17936,79968,99768
Vocational Rehabilitation Specialist,6648,9,Strikeable,6982,7803,8314,821,1332,18721,83784,99768
Vocational Rehabilitation Specialist,6648,10,Strikeable,7327,7803,8314,476,987,19571,87924,99768
Water Resource Data Technician 1,8510,1,Strikeable,3483,3865,4301,382,818,10091,41796,51612
Water Resource Data Technician 1,8510,2,Strikeable,3629,4036,4498,407,869,10451,43548,53976
Water Resource Data Technician 1,8510,3,Strikeable,3790,4222,4715,432,925,10848,45480,56580
Water Resource Data Technician 1,8510,4,Strikeable,3964,4425,4943,461,979,11277,47568,59316
Water Resource Data Technician 1,8510,5,Strikeable,4155,4639,5169,484,1014,11748,49860,62028
Water Resource Data Technician 1,8510,6,Strikeable,4356,4851,5420,495,1064,12244,52272,65040
Water Resource Data Technician 1,8510,7,Strikeable,4555,5086,5695,531,1140,12735,54660,68340
Water Resource Data Technician 1,8510,8,Strikeable,4776,5345,5964,569,1188,13280,57312,71568
Water Resource Data Technician 1,8510,9,Strikeable,5019,5598,5964,579,945,13879,60228,71568
Water Resource Data Technician 1,8510,10,Strikeable,5256,5598,5964,342,708,14464,63072,71568
Water Resource Data Technician 2,8511,1,Strikeable,3790,4425,4943,635,1153,10848,45480,59316
Water Resource Data Technician 2,8511,2,Strikeable,3964,4425,4943,461,979,11277,47568,59316
Water Resource Data Technician 2,8511,3,Strikeable,4155,4639,5169,484,1014,11748,49860,62028
Water Resource Data Technician 2,8511,4,Strikeable,4356,4851,5420,495,1064,12244,52272,65040
Water Resource Data Technician 2,8511,5,Strikeable,4555,5086,5695,531,1140,12735,54660,68340
Water Resource Data Technician 2,8511,6,Strikeable,4776,5345,5964,569,1188,13280,57312,71568
Water Resource Data Technician 2,8511,7,Strikeable,5019,5598,6245,579,1226,13879,60228,74940
Water Resource Data Technician 2,8511,8,Strikeable,5256,5861,6549,605,1293,14464,63072,78588
Water Resource Data Technician 2,8511,9,Strikeable,5503,6146,6549,643,1046,15073,66036,78588
Water Resource Data Technician 2,8511,10,Strikeable,5771,6146,6549,375,778,15734,69252,78588
Wildland Fire Dispatcher,8364,1,Strikeable,3005,3427,3784,422,779,8912,36060,45408
Wildland Fire Dispatcher,8364,2,Strikeable,3095,3427,3784,332,689,9134,37140,45408
Wildland Fire Dispatcher,8364,3,Strikeable,3218,3552,3952,334,734,9437,38616,47424
Wildland Fire Dispatcher,8364,4,Strikeable,3335,3709,4118,374,783,9726,40020,49416
Wildland Fire Dispatcher,8364,5,Strikeable,3483,3865,4301,382,818,10091,41796,51612
Wildland Fire Dispatcher,8364,6,Strikeable,3629,4036,4498,407,869,10451,43548,53976
Wildland Fire Dispatcher,8364,7,Strikeable,3790,4222,4715,432,925,10848,45480,56580
Wildland Fire Dispatcher,8364,8,Strikeable,3964,4425,4943,461,979,11277,47568,59316
Wildland Fire Dispatcher,8364,9,Strikeable,4155,4639,4943,484,788,11748,49860,59316
Wildland Fire Dispatcher,8364,10,Strikeable,4356,4639,4943,283,587,12244,52272,59316
Wildland Fire Dispatcher Entry,8363,1,Strikeable,0,,,,,1500,0,
Wildland Fire Dispatcher Entry,8363,2,Strikeable,0,,,,,1500,0,
Wildland Fire Dispatcher Entry,8363,3,Strikeable,0,,,,,1500,0,
Wildland Fire Dispatcher Entry,8363,4,Strikeable,0,,,,,1500,0,
Wildland Fire Dispatcher Entry,8363,5,Strikeable,3005,3427,3784,422,779,8912,36060,45408
Wildland Fire Dispatcher Entry,8363,6,Strikeable,3095,3427,3784,332,689,9134,37140,45408
Wildland Fire Dispatcher Entry,8363,7,Strikeable,3218,3552,3952,334,734,9437,38616,47424
Wildland Fire Dispatcher Entry,8363,8,Strikeable,3335,3709,4118,374,783,9726,40020,49416
Wildland Fire Dispatcher Entry,8363,9,Strikeable,3483,3865,4118,382,635,10091,41796,49416
Wildland Fire Dispatcher Entry,8363,10,Strikeable,3629,3865,4118,236,489,10451,43548,49416
Wildland Fire Suppression Specialist,8355,1,Strikeable,3218,3709,4118,491,900,9437,38616,49416
Wildland Fire Suppression Specialist,8355,2,Strikeable,3335,3709,4118,374,783,9726,40020,49416
Wildland Fire Suppression Specialist,8355,3,Strikeable,3483,3865,4301,382,818,10091,41796,51612
Wildland Fire Suppression Specialist,8355,4,Strikeable,3629,4036,4498,407,869,10451,43548,53976
Wildland Fire Suppression Specialist,8355,5,Strikeable,3790,4222,4715,432,925,10848,45480,56580
Wildland Fire Suppression Specialist,8355,6,Strikeable,3964,4425,4943,461,979,11277,47568,59316
Wildland Fire Suppression Specialist,8355,7,Strikeable,4155,4639,5169,484,1014,11748,49860,62028
Wildland Fire Suppression Specialist,8355,8,Strikeable,4356,4851,5420,495,1064,12244,52272,65040
Wildland Fire Suppression Specialist,8355,9,Strikeable,4555,5086,5420,531,865,12735,54660,65040
Wildland Fire Suppression Specialist,8355,10,Strikeable,4776,5086,5420,310,644,13280,57312,65040
Wildland Fire Suppression Specialist Entry,8354,1,Strikeable,0,,,,,1500,0,
Wildland Fire Suppression Specialist Entry,8354,2,Strikeable,0,,,,,1500,0,
Wildland Fire Suppression Specialist Entry,8354,3,Strikeable,3005,3296,3652,291,647,8912,36060,43824
Wildland Fire Suppression Specialist Entry,8354,4,Strikeable,3095,3427,3784,332,689,9134,37140,45408
Wildland Fire Suppression Specialist Entry,8354,5,Strikeable,3218,3552,3952,334,734,9437,38616,47424
Wildland Fire Suppression Specialist Entry,8354,6,Strikeable,3335,3709,4118,374,783,9726,40020,49416
Wildland Fire Suppression Specialist Entry,8354,7,Strikeable,3483,3865,4301,382,818,10091,41796,51612
Wildland Fire Suppression Specialist Entry,8354,8,Strikeable,3629,4036,4498,407,869,10451,43548,53976
Wildland Fire Suppression Specialist Entry,8354,9,Strikeable,3790,4222,4498,432,708,10848,45480,53976
Wildland Fire Suppression Specialist Entry,8354,10,Strikeable,3964,4222,4498,258,534,11277,47568,53976
Word Processing Technician 2,531,1,Strikeable,0,,,,,1500,0,
Word Processing Technician 2,531,2,Strikeable,3005,3296,3652,291,647,8912,36060,43824
Word Processing Technician 2,531,3,Strikeable,3095,3427,3784,332,689,9134,37140,45408
Word Processing Technician 2,531,4,Strikeable,3218,3552,3952,334,734,9437,38616,47424
Word Processing Technician 2,531,5,Strikeable,3335,3709,4118,374,783,9726,40020,49416
Word Processing Technician 2,531,6,Strikeable,3483,3865,4301,382,818,10091,41796,51612
Word Processing Technician 2,531,7,Strikeable,3629,4036,4498,407,869,10451,43548,53976
Word Processing Technician 2,531,8,Strikeable,3790,4222,4715,432,925,10848,45480,56580
Word Processing Technician 2,531,9,Strikeable,3964,4425,4715,461,751,11277,47568,56580
Word Processing Technician 2,531,10,Strikeable,4155,4425,4715,270,560,11748,49860,56580
Word Processing Technician 3,533,1,Strikeable,3095,3552,3952,457,857,9134,37140,47424
Word Processing Technician 3,533,2,Strikeable,3218,3552,3952,334,734,9437,38616,47424
Word Processing Technician 3,533,3,Strikeable,3335,3709,4118,374,783,9726,40020,49416
Word Processing Technician 3,533,4,Strikeable,3483,3865,4301,382,818,10091,41796,51612
Word Processing Technician 3,533,5,Strikeable,3629,4036,4498,407,869,10451,43548,53976
Word Processing Technician 3,533,6,Strikeable,3790,4222,4715,432,925,10848,45480,56580
Word Processing Technician 3,533,7,Strikeable,3964,4425,4943,461,979,11277,47568,59316
Word Processing Technician 3,533,8,Strikeable,4155,4639,5169,484,1014,11748,49860,62028
Word Processing Technician 3,533,9,Strikeable,4356,4851,5169,495,813,12244,52272,62028
Word Processing Technician 3,533,10,Strikeable,4555,4851,5169,296,614,12735,54660,62028
Youth Corrections Unit Coordinator,6755,1,Strikeable,4155,4639,5169,484,1014,11748,49860,62028
Youth Corrections Unit Coordinator,6755,2,Strikeable,4356,4851,5420,495,1064,12244,52272,65040
Youth Corrections Unit Coordinator,6755,3,Strikeable,4555,5086,5695,531,1140,12735,54660,68340
Youth Corrections Unit Coordinator,6755,4,Strikeable,4776,5345,5964,569,1188,13280,57312,71568
Youth Corrections Unit Coordinator,6755,5,Strikeable,5019,5598,6245,579,1226,13879,60228,74940
Youth Corrections Unit Coordinator,6755,6,Strikeable,5256,5861,6549,605,1293,14464,63072,78588
Youth Corrections Unit Coordinator,6755,7,Strikeable,5503,6146,6866,643,1363,15073,66036,82392
Youth Corrections Unit Coordinator,6755,8,Strikeable,5771,6444,7206,673,1435,15734,69252,86472
Youth Corrections Unit Coordinator,6755,9,Strikeable,6051,6763,7206,712,1155,16424,72612,86472
Youth Corrections Unit Coordinator,6755,10,Strikeable,6350,6763,7206,413,856,17162,76200,86472
Accountant 1,,1,Non-strikeable,4547,5076,5160,529,613,12715,54564,61920
Accounting Technician,,1,Non-strikeable,3780,4418,4921,638,1141,10823,45360,59052
Activities Coordinator,,1,Non-strikeable,3780,4619,5160,839,1380,10823,45360,61920
Administrative Specialist 1,,1,Non-strikeable,3477,4026,4493,549,1016,10076,41724,53916
Administrative Specialist 2,,1,Non-strikeable,3959,4619,5160,660,1201,11265,47508,61920
Apprenticeship Representative,,1,Non-strikeable,4547,5076,5667,529,1120,12715,54564,68004
Automotive Fleet Attendant,,1,Non-strikeable,3114,3551,3946,437,832,9180,37368,47352
Automotive Technician 1,,1,Non-strikeable,3780,4418,4921,638,1141,10823,45360,59052
Automotive Technician 2,,1,Non-strikeable,4547,5076,5667,529,1120,12715,54564,68004
Behavioral Health Specialist 3,,1,Non-strikeable,5920,6608,7382,688,1462,16101,71040,88584
Biological Science Assistant,,1,Non-strikeable,0,,,,,1500,0,
Business & Employment Specialist 2,,1,Non-strikeable,4148,4619,5160,471,1012,11731,49776,61920
Certified Occupation Therapist Assistant,,1,Non-strikeable,3959,4843,5408,884,1449,11265,47508,64896
Chemist 3,,1,Non-strikeable,5920,6608,7382,688,1462,16101,71040,88584
Child Support Case Manager,,1,Non-strikeable,4148,4843,5408,695,1260,11731,49776,64896
Child Support Case Manager Entry,,1,Non-strikeable,3780,4418,4921,638,1141,10823,45360,59052
Child Support Specialist,,1,Non-strikeable,4547,5076,5667,529,1120,12715,54564,68004
Civil Rights Investigator 1,,1,Non-strikeable,4148,4843,5408,695,1260,11731,49776,64896
Compliance Specialist 1,,1,Non-strikeable,4148,4843,5408,695,1260,11731,49776,64896
Compliance Specialist 3,,1,Non-strikeable,5920,6608,7382,688,1462,16101,71040,88584
Cook,,1,Non-strikeable,3477,4026,4493,549,1016,10076,41724,53916
Custodial Services Coordinator,,1,Non-strikeable,3009,3446,3783,437,774,8921,36108,45396
Data Entry Control Technician,,1,Non-strikeable,0,,,,,1500,0,
Data Entry Operator,,1,Non-strikeable,0,,,,,1500,0,
Dental Assistant 2,,1,Non-strikeable,3959,4843,5408,884,1449,11265,47508,64896
Dental Hygienist,,1,Non-strikeable,5920,6608,7382,688,1462,16101,71040,88584
Disability Analyst 1,,1,Non-strikeable,4547,5076,5667,529,1120,12715,54564,68004
District Veterinarian,,1,Non-strikeable,5920,6608,7382,688,1462,16101,71040,88584
Dormitory Counselor 1,,1,Non-strikeable,3334,3838,4289,504,955,9723,40008,51468
Dormitory Counselor 2,,1,Non-strikeable,3959,4619,5160,660,1201,11265,47508,61920
Economist 1,,1,Non-strikeable,4547,5076,5667,529,1120,12715,54564,68004
Electronic Publishing Design Specialist 1,,1,Non-strikeable,3477,4026,4493,549,1016,10076,41724,53916
Employment Adjudicator,,1,Non-strikeable,4547,5076,5667,529,1120,12715,54564,68004
Employment Appeals Board Legal Staff,,1,Non-strikeable,5920,6608,7382,688,1462,16101,71040,88584
Engineering Technician 2,,1,Non-strikeable,3780,4418,4921,638,1141,10823,45360,59052
Engineering Technician 3,,1,Non-strikeable,4148,4843,5408,695,1260,11731,49776,64896
Equipment Operator,,1,Non-strikeable,4148,4843,5408,695,1260,11731,49776,64896
Executive Support Specialist 1,,1,Non-strikeable,3477,4026,4493,549,1016,10076,41724,53916
Executive Support Specialist 2,,1,Non-strikeable,3959,4619,5160,660,1201,11265,47508,61920
Facility Energy Technician 4,,1,Non-strikeable,5920,6608,7382,688,1462,16101,71040,88584
Fiscal Analyst 1,,1,Non-strikeable,4547,5076,5667,529,1120,12715,54564,68004
Fiscal Auditor 1,,1,Non-strikeable,4547,5076,5667,529,1120,12715,54564,68004
Fish and Wildlife Technical Coordinator,,1,Non-strikeable,4148,4843,5408,695,1260,11731,49776,64896
Fish and Wildlife Technician,,1,Non-strikeable,3477,4026,4493,549,1016,10076,41724,53916
Fish and Wildlife Technician Entry,,1,Non-strikeable,3009,3316,3672,307,663,8921,36108,44064
Fish and Wildlife Technician Senior,,1,Non-strikeable,3780,4216,4707,436,927,10823,45360,56484
Food Service Worker,,1,Non-strikeable,3009,3551,3946,542,937,8921,36108,47352
Forest Crew Coordinator,,1,Non-strikeable,3780,4418,4921,638,1141,10823,45360,59052
Forest Lookout,,1,Non-strikeable,0,,,,,1500,0,
Forest Management Technician,,1,Non-strikeable,3334,3838,4289,504,955,9723,40008,51468
Forest Officer,,1,Non-strikeable,4547,5076,5667,529,1120,12715,54564,68004
Governmental Auditor 3,,1,Non-strikeable,5920,6608,7382,688,1462,16101,71040,88584
Grounds Maintenance Worker 1,,1,Non-strikeable,3114,3551,3946,437,832,9180,37368,47352
Grounds Maintenance Worker 2,,1,Non-strikeable,3477,4026,4493,549,1016,10076,41724,53916
Group Life Coordinator 1,,1,Non-strikeable,3236,3838,4289,602,1053,9481,38832,51468
Group Life Coordinator 2,,1,Non-strikeable,3780,4619,5160,839,1380,10823,45360,61920
Human Services Assistant 2,,1,Non-strikeable,3334,3703,4090,369,756,9723,40008,49080
Human Services Case Manager,,1,Non-strikeable,4148,4843,5408,695,1260,11731,49776,64896
Human Services Specialist 1,,1,Non-strikeable,3236,3703,4090,467,854,9481,38832,49080
Human Services Specialist 2,,1,Non-strikeable,3477,4026,4493,549,1016,10076,41724,53916
Human Services Specialist 3,,1,Non-strikeable,3780,4418,4921,638,1141,10823,45360,59052
Incident Response Operations Specialist,,1,Non-strikeable,3959,4619,5160,660,1201,11265,47508,61920
Industrial Hygienist 3,,1,Non-strikeable,5920,6608,7382,688,1462,16101,71040,88584
Information Systems Specialist 2,,1,Non-strikeable,4148,4843,5408,695,1260,11731,49776,64896
Information Systems Specialist 6,,1,Non-strikeable,5920,6608,7382,688,1462,16101,71040,88584
Information Systems Specialist 7,,1,Non-strikeable,5920,6608,7382,688,1462,16101,71040,88584
Investigator 1,,1,Non-strikeable,3780,4418,4921,638,1141,10823,45360,59052
Investigator 2,,1,Non-strikeable,4547,5076,5667,529,1120,12715,54564,68004
Laboratory Technician 2,,1,Non-strikeable,3477,4026,4493,549,1016,10076,41724,53916
Laborer/Student Worker,,1,Non-strikeable,0,,,,,1500,0,
Licensed Practical Nurse,,1,Non-strikeable,4129,4611,5146,482,1017,11684,49548,61752
Livestock Brand Inspector,,1,Non-strikeable,3236,3703,4090,467,854,9481,38832,49080
Loan Specialist 1,,1,Non-strikeable,4547,5076,5667,529,1120,12715,54564,68004
Mail Delivery Driver,,1,Non-strikeable,3236,3703,4090,467,854,9481,38832,49080
Mail Equipment Operator 1,,1,Non-strikeable,0,,,,,1500,0,
Mail Equipment Operator 2,,1,Non-strikeable,3236,3703,4090,467,854,9481,38832,49080
Mail Services Assistant,,1,Non-strikeable,3009,3446,3783,437,774,8921,36108,45396
Manual Arts Instructor,,1,Non-strikeable,3477,3838,4289,361,812,10076,41724,51468
Medical Laboratory Technician 2,,1,Non-strikeable,3959,4619,5160,660,1201,11265,47508,61920
Mental Health Security Technician,,1,Non-strikeable,3477,4216,4707,739,1230,10076,41724,56484
Mental Health Therapist 1,,1,Non-strikeable,3477,4216,4707,739,1230,10076,41724,56484
Mental Health Therapist 2,,1,Non-strikeable,3780,4619,5160,839,1380,10823,45360,61920
Mental Health Therapy Coordinator,,1,Non-strikeable,3780,4619,5160,839,1380,10823,45360,61920
Mental Health Therapy Technician,,1,Non-strikeable,3236,3838,4289,602,1053,9481,38832,51468
Microbiologist 1,,1,Non-strikeable,4547,5076,5667,529,1120,12715,54564,68004
Motor Carrier Enforcement Officer 1,,1,Non-strikeable,4148,4843,5408,695,1260,11731,49776,64896
Natural Resource Specialist 1,,1,Non-strikeable,4148,4843,5408,695,1260,11731,49776,64896
Nutrition Consultant,,1,Non-strikeable,5920,6608,7382,688,1462,16101,71040,88584
Occupational Safety Specialist 3,,1,Non-strikeable,5920,6608,7382,688,1462,16101,71040,88584
Office Coordinator,,1,Non-strikeable,3236,3703,4090,467,854,9481,38832,49080
Office Specialist 1,,1,Non-strikeable,3009,3446,3783,437,774,8921,36108,45396
Office Specialist 2,,1,Non-strikeable,3236,3703,4090,467,854,9481,38832,49080
Operations & Policy Analyst 1,,1,Non-strikeable,4547,5076,5667,529,1120,12715,54564,68004
Park Ranger 2,,1,Non-strikeable,3959,4619,5160,660,1201,11265,47508,61920
Park Ranger Assistant,,1,Non-strikeable,0,,,,,1500,0,
Park Specialist,,1,Non-strikeable,3477,4026,4493,549,1016,10076,41724,53916
Parking Services Representative,,1,Non-strikeable,3114,3551,3946,437,832,9180,37368,47352
Parts Specialist 2,,1,Non-strikeable,3959,4619,5160,660,1201,11265,47508,61920
Payroll Analyst,,1,Non-strikeable,4148,4843,5408,695,1260,11731,49776,64896
Pharmacist Resident,,1,Non-strikeable,4547,5076,5667,529,1120,12715,54564,68004
Pharmacy Clerk & Technician 2,,1,Non-strikeable,3334,4026,4493,692,1159,9723,40008,53916
Pharmacy Clerk & Technician 3,,1,Non-strikeable,3477,4216,4707,739,1230,10076,41724,56484
Physical/Electronic Security Technician,,1,Non-strikeable,3959,4619,5160,660,1201,11265,47508,61920
Print Services Technician,,1,Non-strikeable,3334,3838,4289,504,955,9723,40008,51468
Printing Production Coordinator,,1,Non-strikeable,4547,5076,5667,529,1120,12715,54564,68004
Procurement & Contract Specialist 1,,1,Non-strikeable,4547,5076,5667,529,1120,12715,54564,68004
Procurement & Contract Specialist 3,,1,Non-strikeable,5920,6608,7382,688,1462,16101,71040,88584
Procurement And Contract Assistant,,1,Non-strikeable,3780,4418,4921,638,1141,10823,45360,59052
Program Analyst 1,,1,Non-strikeable,4547,5076,5667,529,1120,12715,54564,68004
Program Analyst 3,,1,Non-strikeable,5920,6608,7382,688,1462,16101,71040,88584
Psychiatric Social Worker,,1,Non-strikeable,5920,6608,7382,688,1462,16101,71040,88584
Public Affairs Specialist 2,,1,Non-strikeable,5920,6608,7382,688,1462,16101,71040,88584
Public Health Toxicologist 1,,1,Non-strikeable,5920,6608,7382,688,1462,16101,71040,88584
Public Service Representative 2,,1,Non-strikeable,3009,3446,3783,437,774,8921,36108,45396
Public Service Representative 3,,1,Non-strikeable,3236,3703,4090,467,854,9481,38832,49080
Public Service Representative 4,,1,Non-strikeable,3959,4619,5160,660,1201,11265,47508,61920
Rehabilitation Instructor For The Blind,,1,Non-strikeable,4547,5076,5667,529,1120,12715,54564,68004
Rehabilitation Instructor For The Blind (Entry),,1,Non-strikeable,4148,4619,5160,471,1012,11731,49776,61920
Research Analyst 1,,1,Non-strikeable,3780,4418,4921,638,1141,10823,45360,59052
Research Analyst 2,,1,Non-strikeable,4547,5076,5667,529,1120,12715,54564,68004
Retirement Counselor 1,,1,Non-strikeable,3959,4619,5160,660,1201,11265,47508,61920
Revenue Agent 1,,1,Non-strikeable,3477,4026,4493,549,1016,10076,41724,53916
Revenue Agent 2,,1,Non-strikeable,3780,4216,4707,436,927,10823,45360,56484
Revenue Agent 3,,1,Non-strikeable,4148,4843,5408,695,1260,11731,49776,64896
Safety Specialist 1,,1,Non-strikeable,4547,5076,5667,529,1120,12715,54564,68004
Scientific Instrument Technician,,1,Non-strikeable,4148,4843,5408,695,1260,11731,49776,64896
Seamster,,1,Non-strikeable,3236,3838,4289,602,1053,9481,38832,51468
Shipping Point Inspector 1,,1,Non-strikeable,3236,3703,4090,467,854,9481,38832,49080
Shipping Point Inspector 2,,1,Non-strikeable,3477,4026,4493,549,1016,10076,41724,53916
Sign Technician 1,,1,Non-strikeable,3780,4418,4921,638,1141,10823,45360,59052
Social Service Assistant,,1,Non-strikeable,3477,4026,4493,549,1016,10076,41724,53916
State Library Specialist 1,,1,Non-strikeable,0,,,,,1500,0,
Supply Specialist 1,,1,Non-strikeable,3114,3551,3946,437,832,9180,37368,47352
Supply Specialist 2,,1,Non-strikeable,3959,4619,5160,660,1201,11265,47508,61920
Tax Auditor/Entry,,1,Non-strikeable,3959,4619,5160,660,1201,11265,47508,61920
Teaching Assistant,,1,Non-strikeable,3236,3703,4090,467,854,9481,38832,49080
Training & Development Specialist 1,,1,Non-strikeable,4547,5076,5667,529,1120,12715,54564,68004
Transportation Maintenance Coordinator 1,,1,Non-strikeable,4148,4843,5408,695,1260,11731,49776,64896
Transportation Maintenance Specialist 1,,1,Non-strikeable,3477,4026,4493,549,1016,10076,41724,53916
Transportation Maintenance Specialist 2,,1,Non-strikeable,3780,4418,4921,638,1141,10823,45360,59052
Transportation Services Office Leader,,1,Non-strikeable,4148,4843,5408,695,1260,11731,49776,64896
Transportation Services Representative 1,,1,Non-strikeable,3477,4026,4493,549,1016,10076,41724,53916
Transportation Services Representative 2,,1,Non-strikeable,3780,4418,4921,638,1141,10823,45360,59052
Transportation Telecommunications Specialist 1,,1,Non-strikeable,3959,4619,5160,660,1201,11265,47508,61920
Transporting Mental Health Aide,,1,Non-strikeable,3477,4216,4707,739,1230,10076,41724,56484
Truck Driver 1,,1,Non-strikeable,3477,4026,4493,549,1016,10076,41724,53916
Truck Driver 2,,1,Non-strikeable,3959,4619,5160,660,1201,11265,47508,61920
Veterans Service Officer,,1,Non-strikeable,4547,5076,5667,529,1120,12715,54564,68004
Veterans Trust Officer,,1,Non-strikeable,4547,5076,5667,529,1120,12715,54564,68004
Vocational Rehabilitation Counselor Entry,,1,Non-strikeable,3959,4418,4921,459,962,11265,47508,59052
Water Resource Data Technician 1,,1,Non-strikeable,3780,4216,4707,436,927,10823,45360,56484
Water Resource Data Technician 2,,1,Non-strikeable,4148,4843,5408,695,1260,11731,49776,64896
Wildland Fire Dispatcher,,1,Non-strikeable,3236,3703,4090,467,854,9481,38832,49080
Wildland Fire Dispatcher Entry,,1,Non-strikeable,0,,,,,1500,0,
Wildland Fire Suppression Specialist,,1,Non-strikeable,3477,4026,4493,549,1016,10076,41724,53916
Wildland Fire Suppression Specialist Entry,,1,Non-strikeable,3009,3316,3672,307,663,8921,36108,44064
Word Processing Technician 2,,1,Non-strikeable,3114,3446,3783,332,669,9180,37368,45396
Word Processing Technician 3,,1,Non-strikeable,3334,3838,4289,504,955,9723,40008,51468
Youth Corrections Unit Coordinator,,1,Non-strikeable,4547,5076,5667,529,1120,12715,54564,68004
Accountant 1,,2,Non-strikeable,4766,5076,5408,310,642,13255,57192,64896
Accounting Technician,,2,Non-strikeable,3959,4418,4921,459,962,11265,47508,59052
Activities Coordinator,,2,Non-strikeable,3959,4619,5160,660,1201,11265,47508,61920
Administrative Specialist 1,,2,Non-strikeable,3604,4026,4493,422,889,10389,43248,53916
Administrative Specialist 2,,2,Non-strikeable,4148,4619,5160,471,1012,11731,49776,61920
Apprenticeship Representative,,2,Non-strikeable,4766,5319,5936,553,1170,13255,57192,71232
Automotive Fleet Attendant,,2,Non-strikeable,3236,3551,3946,315,710,9481,38832,47352
Automotive Technician 1,,2,Non-strikeable,3959,4418,4921,459,962,11265,47508,59052
Automotive Technician 2,,2,Non-strikeable,4766,5319,5936,553,1170,13255,57192,71232
Behavioral Health Specialist 3,,2,Non-strikeable,6205,6928,7735,723,1530,16804,74460,92820
Biological Science Assistant,,2,Non-strikeable,3009,3446,3783,437,774,8921,36108,45396
Business & Employment Specialist 2,,2,Non-strikeable,4337,4843,5408,506,1071,12197,52044,64896
Certified Occupation Therapist Assistant,,2,Non-strikeable,4148,4843,5408,695,1260,11731,49776,64896
Chemist 3,,2,Non-strikeable,6205,6928,7735,723,1530,16804,74460,92820
Child Support Case Manager,,2,Non-strikeable,4337,4843,5408,506,1071,12197,52044,64896
Child Support Case Manager Entry,,2,Non-strikeable,3959,4418,4921,459,962,11265,47508,59052
Child Support Specialist,,2,Non-strikeable,4766,5319,5936,553,1170,13255,57192,71232
Civil Rights Investigator 1,,2,Non-strikeable,4337,4843,5408,506,1071,12197,52044,64896
Compliance Specialist 1,,2,Non-strikeable,4337,4843,5408,506,1071,12197,52044,64896
Compliance Specialist 3,,2,Non-strikeable,6205,6928,7735,723,1530,16804,74460,92820
Cook,,2,Non-strikeable,3604,4026,4493,422,889,10389,43248,53916
Custodial Services Coordinator,,2,Non-strikeable,3114,3446,3783,332,669,9180,37368,45396
Data Entry Control Technician,,2,Non-strikeable,3009,3446,3783,437,774,8921,36108,45396
Data Entry Operator,,2,Non-strikeable,3009,3446,3783,437,774,8921,36108,45396
Dental Assistant 2,,2,Non-strikeable,4148,4843,5408,695,1260,11731,49776,64896
Dental Hygienist,,2,Non-strikeable,6205,6928,7735,723,1530,16804,74460,92820
Disability Analyst 1,,2,Non-strikeable,4766,5319,5936,553,1170,13255,57192,71232
District Veterinarian,,2,Non-strikeable,6205,6928,7735,723,1530,16804,74460,92820
Dormitory Counselor 1,,2,Non-strikeable,3477,3838,4289,361,812,10076,41724,51468
Dormitory Counselor 2,,2,Non-strikeable,4148,4619,5160,471,1012,11731,49776,61920
Economist 1,,2,Non-strikeable,4766,5319,5936,553,1170,13255,57192,71232
Electronic Publishing Design Specialist 1,,2,Non-strikeable,3604,4026,4493,422,889,10389,43248,53916
Employment Adjudicator,,2,Non-strikeable,4766,5319,5936,553,1170,13255,57192,71232
Employment Appeals Board Legal Staff,,2,Non-strikeable,6205,6928,7735,723,1530,16804,74460,92820
Engineering Technician 2,,2,Non-strikeable,3959,4418,4921,459,962,11265,47508,59052
Engineering Technician 3,,2,Non-strikeable,4337,4843,5408,506,1071,12197,52044,64896
Equipment Operator,,2,Non-strikeable,4337,4843,5408,506,1071,12197,52044,64896
Executive Support Specialist 1,,2,Non-strikeable,3604,4026,4493,422,889,10389,43248,53916
Executive Support Specialist 2,,2,Non-strikeable,4148,4619,5160,471,1012,11731,49776,61920
Facility Energy Technician 4,,2,Non-strikeable,6205,6928,7735,723,1530,16804,74460,92820
Fiscal Analyst 1,,2,Non-strikeable,4766,5319,5936,553,1170,13255,57192,71232
Fiscal Auditor 1,,2,Non-strikeable,4766,5319,5936,553,1170,13255,57192,71232
Fish and Wildlife Technical Coordinator,,2,Non-strikeable,4337,4843,5408,506,1071,12197,52044,64896
Fish and Wildlife Technician,,2,Non-strikeable,3604,4026,4493,422,889,10389,43248,53916
Fish and Wildlife Technician Entry,,2,Non-strikeable,3114,3446,3783,332,669,9180,37368,45396
Fish and Wildlife Technician Senior,,2,Non-strikeable,3959,4418,4921,459,962,11265,47508,59052
Food Service Worker,,2,Non-strikeable,3114,3551,3946,437,832,9180,37368,47352
Forest Crew Coordinator,,2,Non-strikeable,3959,4418,4921,459,962,11265,47508,59052
Forest Lookout,,2,Non-strikeable,0,,,,,1500,0,
Forest Management Technician,,2,Non-strikeable,3477,3838,4289,361,812,10076,41724,51468
Forest Officer,,2,Non-strikeable,4766,5319,5936,553,1170,13255,57192,71232
Governmental Auditor 3,,2,Non-strikeable,6205,6928,7735,723,1530,16804,74460,92820
Grounds Maintenance Worker 1,,2,Non-strikeable,3236,3551,3946,315,710,9481,38832,47352
Grounds Maintenance Worker 2,,2,Non-strikeable,3604,4026,4493,422,889,10389,43248,53916
Group Life Coordinator 1,,2,Non-strikeable,3334,3838,4289,504,955,9723,40008,51468
Group Life Coordinator 2,,2,Non-strikeable,3959,4619,5160,660,1201,11265,47508,61920
Human Services Assistant 2,,2,Non-strikeable,3477,3838,4289,361,812,10076,41724,51468
Human Services Case Manager,,2,Non-strikeable,4337,4843,5408,506,1071,12197,52044,64896
Human Services Specialist 1,,2,Non-strikeable,3334,3703,4090,369,756,9723,40008,49080
Human Services Specialist 2,,2,Non-strikeable,3604,4026,4493,422,889,10389,43248,53916
Human Services Specialist 3,,2,Non-strikeable,3959,4418,4921,459,962,11265,47508,59052
Incident Response Operations Specialist,,2,Non-strikeable,4148,4619,5160,471,1012,11731,49776,61920
Industrial Hygienist 3,,2,Non-strikeable,6205,6928,7735,723,1530,16804,74460,92820
Information Systems Specialist 2,,2,Non-strikeable,4337,4843,5408,506,1071,12197,52044,64896
Information Systems Specialist 6,,2,Non-strikeable,6205,6928,7735,723,1530,16804,74460,92820
Information Systems Specialist 7,,2,Non-strikeable,6205,6928,7735,723,1530,16804,74460,92820
Investigator 1,,2,Non-strikeable,3959,4418,4921,459,962,11265,47508,59052
Investigator 2,,2,Non-strikeable,4766,5319,5936,553,1170,13255,57192,71232
Laboratory Technician 2,,2,Non-strikeable,3604,4026,4493,422,889,10389,43248,53916
Laborer/Student Worker,,2,Non-strikeable,3009,3446,3783,437,774,8921,36108,45396
Licensed Practical Nurse,,2,Non-strikeable,4330,4830,5387,500,1057,12180,51960,64644
Livestock Brand Inspector,,2,Non-strikeable,3334,3703,4090,369,756,9723,40008,49080
Loan Specialist 1,,2,Non-strikeable,4766,5319,5936,553,1170,13255,57192,71232
Mail Delivery Driver,,2,Non-strikeable,3334,3703,4090,369,756,9723,40008,49080
Mail Equipment Operator 1,,2,Non-strikeable,3009,3446,3783,437,774,8921,36108,45396
Mail Equipment Operator 2,,2,Non-strikeable,3334,3703,4090,369,756,9723,40008,49080
Mail Services Assistant,,2,Non-strikeable,3114,3446,3783,332,669,9180,37368,45396
Manual Arts Instructor,,2,Non-strikeable,3604,4026,4493,422,889,10389,43248,53916
Medical Laboratory Technician 2,,2,Non-strikeable,4148,4619,5160,471,1012,11731,49776,61920
Mental Health Security Technician,,2,Non-strikeable,3604,4216,4707,612,1103,10389,43248,56484
Mental Health Therapist 1,,2,Non-strikeable,3604,4216,4707,612,1103,10389,43248,56484
Mental Health Therapist 2,,2,Non-strikeable,3959,4619,5160,660,1201,11265,47508,61920
Mental Health Therapy Coordinator,,2,Non-strikeable,3959,4619,5160,660,1201,11265,47508,61920
Mental Health Therapy Technician,,2,Non-strikeable,3334,3838,4289,504,955,9723,40008,51468
Microbiologist 1,,2,Non-strikeable,4766,5319,5936,553,1170,13255,57192,71232
Motor Carrier Enforcement Officer 1,,2,Non-strikeable,4337,4843,5408,506,1071,12197,52044,64896
Natural Resource Specialist 1,,2,Non-strikeable,4337,4843,5408,506,1071,12197,52044,64896
Nutrition Consultant,,2,Non-strikeable,6205,6928,7735,723,1530,16804,74460,92820
Occupational Safety Specialist 3,,2,Non-strikeable,6205,6928,7735,723,1530,16804,74460,92820
Office Coordinator,,2,Non-strikeable,3334,3703,4090,369,756,9723,40008,49080
Office Specialist 1,,2,Non-strikeable,3114,3446,3783,332,669,9180,37368,45396
Office Specialist 2,,2,Non-strikeable,3334,3703,4090,369,756,9723,40008,49080
Operations & Policy Analyst 1,,2,Non-strikeable,4766,5319,5936,553,1170,13255,57192,71232
Park Ranger 2,,2,Non-strikeable,4148,4619,5160,471,1012,11731,49776,61920
Park Ranger Assistant,,2,Non-strikeable,3009,3446,3783,437,774,8921,36108,45396
Park Specialist,,2,Non-strikeable,3604,4026,4493,422,889,10389,43248,53916
Parking Services Representative,,2,Non-strikeable,3236,3551,3946,315,710,9481,38832,47352
Parts Specialist 2,,2,Non-strikeable,4148,4619,5160,471,1012,11731,49776,61920
Payroll Analyst,,2,Non-strikeable,4337,4843,5408,506,1071,12197,52044,64896
Pharmacist Resident,,2,Non-strikeable,4766,5319,5936,553,1170,13255,57192,71232
Pharmacy Clerk & Technician 2,,2,Non-strikeable,3477,4026,4493,549,1016,10076,41724,53916
Pharmacy Clerk & Technician 3,,2,Non-strikeable,3604,4216,4707,612,1103,10389,43248,56484
Physical/Electronic Security Technician,,2,Non-strikeable,4148,4619,5160,471,1012,11731,49776,61920
Print Services Technician,,2,Non-strikeable,3477,3838,4289,361,812,10076,41724,51468
Printing Production Coordinator,,2,Non-strikeable,4766,5319,5936,553,1170,13255,57192,71232
Procurement & Contract Specialist 1,,2,Non-strikeable,4766,5319,5936,553,1170,13255,57192,71232
Procurement & Contract Specialist 3,,2,Non-strikeable,6205,6928,7735,723,1530,16804,74460,92820
Procurement And Contract Assistant,,2,Non-strikeable,3959,4418,4921,459,962,11265,47508,59052
Program Analyst 1,,2,Non-strikeable,4766,5319,5936,553,1170,13255,57192,71232
Program Analyst 3,,2,Non-strikeable,6205,6928,7735,723,1530,16804,74460,92820
Psychiatric Social Worker,,2,Non-strikeable,6205,6928,7735,723,1530,16804,74460,92820
Public Affairs Specialist 2,,2,Non-strikeable,6205,6928,7735,723,1530,16804,74460,92820
Public Health Toxicologist 1,,2,Non-strikeable,6205,6928,7735,723,1530,16804,74460,92820
Public Service Representative 2,,2,Non-strikeable,3114,3446,3783,332,669,9180,37368,45396
Public Service Representative 3,,2,Non-strikeable,3334,3703,4090,369,756,9723,40008,49080
Public Service Representative 4,,2,Non-strikeable,4148,4619,5160,471,1012,11731,49776,61920
Rehabilitation Instructor For The Blind,,2,Non-strikeable,4766,5319,5936,553,1170,13255,57192,71232
Rehabilitation Instructor For The Blind (Entry),,2,Non-strikeable,4337,4843,5408,506,1071,12197,52044,64896
Research Analyst 1,,2,Non-strikeable,3959,4418,4921,459,962,11265,47508,59052
Research Analyst 2,,2,Non-strikeable,4766,5319,5936,553,1170,13255,57192,71232
Retirement Counselor 1,,2,Non-strikeable,4148,4619,5160,471,1012,11731,49776,61920
Revenue Agent 1,,2,Non-strikeable,3604,4026,4493,422,889,10389,43248,53916
Revenue Agent 2,,2,Non-strikeable,3959,4418,4921,459,962,11265,47508,59052
Revenue Agent 3,,2,Non-strikeable,4337,4843,5408,506,1071,12197,52044,64896
Safety Specialist 1,,2,Non-strikeable,4766,5319,5936,553,1170,13255,57192,71232
Scientific Instrument Technician,,2,Non-strikeable,4337,4843,5408,506,1071,12197,52044,64896
Seamster,,2,Non-strikeable,3334,3838,4289,504,955,9723,40008,51468
Shipping Point Inspector 1,,2,Non-strikeable,3334,3703,4090,369,756,9723,40008,49080
Shipping Point Inspector 2,,2,Non-strikeable,3604,4026,4493,422,889,10389,43248,53916
Sign Technician 1,,2,Non-strikeable,3959,4418,4921,459,962,11265,47508,59052
Social Service Assistant,,2,Non-strikeable,3604,4026,4493,422,889,10389,43248,53916
State Library Specialist 1,,2,Non-strikeable,3009,3316,3672,307,663,8921,36108,44064
Supply Specialist 1,,2,Non-strikeable,3236,3551,3946,315,710,9481,38832,47352
Supply Specialist 2,,2,Non-strikeable,4148,4619,5160,471,1012,11731,49776,61920
Tax Auditor/Entry,,2,Non-strikeable,4148,4619,5160,471,1012,11731,49776,61920
Teaching Assistant,,2,Non-strikeable,3334,3703,4090,369,756,9723,40008,49080
Training & Development Specialist 1,,2,Non-strikeable,4766,5319,5936,553,1170,13255,57192,71232
Transportation Maintenance Coordinator 1,,2,Non-strikeable,4337,4843,5408,506,1071,12197,52044,64896
Transportation Maintenance Specialist 1,,2,Non-strikeable,3604,4026,4493,422,889,10389,43248,53916
Transportation Maintenance Specialist 2,,2,Non-strikeable,3959,4418,4921,459,962,11265,47508,59052
Transportation Services Office Leader,,2,Non-strikeable,4337,4843,5408,506,1071,12197,52044,64896
Transportation Services Representative 1,,2,Non-strikeable,3604,4026,4493,422,889,10389,43248,53916
Transportation Services Representative 2,,2,Non-strikeable,3959,4418,4921,459,962,11265,47508,59052
Transportation Telecommunications Specialist 1,,2,Non-strikeable,4148,4619,5160,471,1012,11731,49776,61920
Transporting Mental Health Aide,,2,Non-strikeable,3604,4216,4707,612,1103,10389,43248,56484
Truck Driver 1,,2,Non-strikeable,3604,4026,4493,422,889,10389,43248,53916
Truck Driver 2,,2,Non-strikeable,4148,4619,5160,471,1012,11731,49776,61920
Veterans Service Officer,,2,Non-strikeable,4766,5319,5936,553,1170,13255,57192,71232
Veterans Trust Officer,,2,Non-strikeable,4766,5319,5936,553,1170,13255,57192,71232
Vocational Rehabilitation Counselor Entry,,2,Non-strikeable,4148,4619,5160,471,1012,11731,49776,61920
Water Resource Data Technician 1,,2,Non-strikeable,3959,4418,4921,459,962,11265,47508,59052
Water Resource Data Technician 2,,2,Non-strikeable,4337,4843,5408,506,1071,12197,52044,64896
Wildland Fire Dispatcher,,2,Non-strikeable,3334,3703,4090,369,756,9723,40008,49080
Wildland Fire Dispatcher Entry,,2,Non-strikeable,0,,,,,1500,0,
Wildland Fire Suppression Specialist,,2,Non-strikeable,3604,4026,4493,422,889,10389,43248,53916
Wildland Fire Suppression Specialist Entry,,2,Non-strikeable,3114,3446,3783,332,669,9180,37368,45396
Word Processing Technician 2,,2,Non-strikeable,3236,3551,3946,315,710,9481,38832,47352
Word Processing Technician 3,,2,Non-strikeable,3477,3838,4289,361,812,10076,41724,51468
Youth Corrections Unit Coordinator,,2,Non-strikeable,4766,5319,5936,553,1170,13255,57192,71232
Accountant 1,,3,Non-strikeable,4994,5319,5667,325,673,13817,59928,68004
Accounting Technician,,3,Non-strikeable,4148,4619,5160,471,1012,11731,49776,61920
Activities Coordinator,,3,Non-strikeable,4148,4619,5160,471,1012,11731,49776,61920
Administrative Specialist 1,,3,Non-strikeable,3780,4216,4707,436,927,10823,45360,56484
Administrative Specialist 2,,3,Non-strikeable,4337,4843,5408,506,1071,12197,52044,64896
Apprenticeship Representative,,3,Non-strikeable,4994,5571,6232,577,1238,13817,59928,74784
Automotive Fleet Attendant,,3,Non-strikeable,3334,3703,4090,369,756,9723,40008,49080
Automotive Technician 1,,3,Non-strikeable,4148,4619,5160,471,1012,11731,49776,61920
Automotive Technician 2,,3,Non-strikeable,4994,5571,6232,577,1238,13817,59928,74784
Behavioral Health Specialist 3,,3,Non-strikeable,6505,7259,8104,754,1599,17544,78060,97248
Biological Science Assistant,,3,Non-strikeable,3114,3446,3783,332,669,9180,37368,45396
Business & Employment Specialist 2,,3,Non-strikeable,4547,5076,5667,529,1120,12715,54564,68004
Certified Occupation Therapist Assistant,,3,Non-strikeable,4337,4843,5408,506,1071,12197,52044,64896
Chemist 3,,3,Non-strikeable,6505,7259,8104,754,1599,17544,78060,97248
Child Support Case Manager,,3,Non-strikeable,4547,5076,5667,529,1120,12715,54564,68004
Child Support Case Manager Entry,,3,Non-strikeable,4148,4619,5160,471,1012,11731,49776,61920
Child Support Specialist,,3,Non-strikeable,4994,5571,6232,577,1238,13817,59928,74784
Civil Rights Investigator 1,,3,Non-strikeable,4547,5076,5667,529,1120,12715,54564,68004
Compliance Specialist 1,,3,Non-strikeable,4547,5076,5667,529,1120,12715,54564,68004
Compliance Specialist 3,,3,Non-strikeable,6505,7259,8104,754,1599,17544,78060,97248
Cook,,3,Non-strikeable,3780,4216,4707,436,927,10823,45360,56484
Custodial Services Coordinator,,3,Non-strikeable,3236,3551,3946,315,710,9481,38832,47352
Data Entry Control Technician,,3,Non-strikeable,3114,3446,3783,332,669,9180,37368,45396
Data Entry Operator,,3,Non-strikeable,3114,3446,3783,332,669,9180,37368,45396
Dental Assistant 2,,3,Non-strikeable,4337,4843,5408,506,1071,12197,52044,64896
Dental Hygienist,,3,Non-strikeable,6505,7259,8104,754,1599,17544,78060,97248
Disability Analyst 1,,3,Non-strikeable,4994,5571,6232,577,1238,13817,59928,74784
District Veterinarian,,3,Non-strikeable,6505,7259,8104,754,1599,17544,78060,97248
Dormitory Counselor 1,,3,Non-strikeable,3604,4026,4493,422,889,10389,43248,53916
Dormitory Counselor 2,,3,Non-strikeable,4337,4843,5408,506,1071,12197,52044,64896
Economist 1,,3,Non-strikeable,4994,5571,6232,577,1238,13817,59928,74784
Electronic Publishing Design Specialist 1,,3,Non-strikeable,3780,4216,4707,436,927,10823,45360,56484
Employment Adjudicator,,3,Non-strikeable,4994,5571,6232,577,1238,13817,59928,74784
Employment Appeals Board Legal Staff,,3,Non-strikeable,6505,7259,8104,754,1599,17544,78060,97248
Engineering Technician 2,,3,Non-strikeable,4148,4619,5160,471,1012,11731,49776,61920
Engineering Technician 3,,3,Non-strikeable,4547,5076,5667,529,1120,12715,54564,68004
Equipment Operator,,3,Non-strikeable,4547,5076,5667,529,1120,12715,54564,68004
Executive Support Specialist 1,,3,Non-strikeable,3780,4216,4707,436,927,10823,45360,56484
Executive Support Specialist 2,,3,Non-strikeable,4337,4843,5408,506,1071,12197,52044,64896
Facility Energy Technician 4,,3,Non-strikeable,6505,7259,8104,754,1599,17544,78060,97248
Fiscal Analyst 1,,3,Non-strikeable,4994,5571,6232,577,1238,13817,59928,74784
Fiscal Auditor 1,,3,Non-strikeable,4994,5571,6232,577,1238,13817,59928,74784
Fish and Wildlife Technical Coordinator,,3,Non-strikeable,4547,5076,5667,529,1120,12715,54564,68004
Fish and Wildlife Technician,,3,Non-strikeable,3780,4216,4707,436,927,10823,45360,56484
Fish and Wildlife Technician Entry,,3,Non-strikeable,3236,3551,3946,315,710,9481,38832,47352
Fish and Wildlife Technician Senior,,3,Non-strikeable,4148,4619,5160,471,1012,11731,49776,61920
Food Service Worker,,3,Non-strikeable,3236,3551,3946,315,710,9481,38832,47352
Forest Crew Coordinator,,3,Non-strikeable,4148,4619,5160,471,1012,11731,49776,61920
Forest Lookout,,3,Non-strikeable,3009,3446,3783,437,774,8921,36108,45396
Forest Management Technician,,3,Non-strikeable,3604,4026,4493,422,889,10389,43248,53916
Forest Officer,,3,Non-strikeable,4994,5571,6232,577,1238,13817,59928,74784
Governmental Auditor 3,,3,Non-strikeable,6505,7259,8104,754,1599,17544,78060,97248
Grounds Maintenance Worker 1,,3,Non-strikeable,3334,3703,4090,369,756,9723,40008,49080
Grounds Maintenance Worker 2,,3,Non-strikeable,3780,4216,4707,436,927,10823,45360,56484
Group Life Coordinator 1,,3,Non-strikeable,3477,3838,4289,361,812,10076,41724,51468
Group Life Coordinator 2,,3,Non-strikeable,4148,4619,5160,471,1012,11731,49776,61920
Human Services Assistant 2,,3,Non-strikeable,3604,4026,4493,422,889,10389,43248,53916
Human Services Case Manager,,3,Non-strikeable,4547,5076,5667,529,1120,12715,54564,68004
Human Services Specialist 1,,3,Non-strikeable,3477,3838,4289,361,812,10076,41724,51468
Human Services Specialist 2,,3,Non-strikeable,3780,4216,4707,436,927,10823,45360,56484
Human Services Specialist 3,,3,Non-strikeable,4148,4619,5160,471,1012,11731,49776,61920
Incident Response Operations Specialist,,3,Non-strikeable,4337,4843,5408,506,1071,12197,52044,64896
Industrial Hygienist 3,,3,Non-strikeable,6505,7259,8104,754,1599,17544,78060,97248
Information Systems Specialist 2,,3,Non-strikeable,4547,5076,5667,529,1120,12715,54564,68004
Information Systems Specialist 6,,3,Non-strikeable,6505,7259,8104,754,1599,17544,78060,97248
Information Systems Specialist 7,,3,Non-strikeable,6505,7259,8104,754,1599,17544,78060,97248
Investigator 1,,3,Non-strikeable,4148,4619,5160,471,1012,11731,49776,61920
Investigator 2,,3,Non-strikeable,4994,5571,6232,577,1238,13817,59928,74784
Laboratory Technician 2,,3,Non-strikeable,3780,4216,4707,436,927,10823,45360,56484
Laborer/Student Worker,,3,Non-strikeable,3114,3446,3783,332,669,9180,37368,45396
Licensed Practical Nurse,,3,Non-strikeable,4535,5056,5644,521,1109,12685,54420,67728
Livestock Brand Inspector,,3,Non-strikeable,3477,3838,4289,361,812,10076,41724,51468
Loan Specialist 1,,3,Non-strikeable,4994,5571,6232,577,1238,13817,59928,74784
Mail Delivery Driver,,3,Non-strikeable,3477,3838,4289,361,812,10076,41724,51468
Mail Equipment Operator 1,,3,Non-strikeable,3114,3446,3783,332,669,9180,37368,45396
Mail Equipment Operator 2,,3,Non-strikeable,3477,3838,4289,361,812,10076,41724,51468
Mail Services Assistant,,3,Non-strikeable,3236,3551,3946,315,710,9481,38832,47352
Manual Arts Instructor,,3,Non-strikeable,3780,4216,4707,436,927,10823,45360,56484
Medical Laboratory Technician 2,,3,Non-strikeable,4337,4843,5408,506,1071,12197,52044,64896
Mental Health Security Technician,,3,Non-strikeable,3780,4216,4707,436,927,10823,45360,56484
Mental Health Therapist 1,,3,Non-strikeable,3780,4216,4707,436,927,10823,45360,56484
Mental Health Therapist 2,,3,Non-strikeable,4148,4619,5160,471,1012,11731,49776,61920
Mental Health Therapy Coordinator,,3,Non-strikeable,4148,4619,5160,471,1012,11731,49776,61920
Mental Health Therapy Technician,,3,Non-strikeable,3477,3838,4289,361,812,10076,41724,51468
Microbiologist 1,,3,Non-strikeable,4994,5571,6232,577,1238,13817,59928,74784
Motor Carrier Enforcement Officer 1,,3,Non-strikeable,4547,5076,5667,529,1120,12715,54564,68004
Natural Resource Specialist 1,,3,Non-strikeable,4547,5076,5667,529,1120,12715,54564,68004
Nutrition Consultant,,3,Non-strikeable,6505,7259,8104,754,1599,17544,78060,97248
Occupational Safety Specialist 3,,3,Non-strikeable,6505,7259,8104,754,1599,17544,78060,97248
Office Coordinator,,3,Non-strikeable,3477,3838,4289,361,812,10076,41724,51468
Office Specialist 1,,3,Non-strikeable,3236,3551,3946,315,710,9481,38832,47352
Office Specialist 2,,3,Non-strikeable,3477,3838,4289,361,812,10076,41724,51468
Operations & Policy Analyst 1,,3,Non-strikeable,4994,5571,6232,577,1238,13817,59928,74784
Park Ranger 2,,3,Non-strikeable,4337,4843,5408,506,1071,12197,52044,64896
Park Ranger Assistant,,3,Non-strikeable,3114,3446,3783,332,669,9180,37368,45396
Park Specialist,,3,Non-strikeable,3780,4216,4707,436,927,10823,45360,56484
Parking Services Representative,,3,Non-strikeable,3334,3703,4090,369,756,9723,40008,49080
Parts Specialist 2,,3,Non-strikeable,4337,4843,5408,506,1071,12197,52044,64896
Payroll Analyst,,3,Non-strikeable,4547,5076,5667,529,1120,12715,54564,68004
Pharmacist Resident,,3,Non-strikeable,4994,5571,6232,577,1238,13817,59928,74784
Pharmacy Clerk & Technician 2,,3,Non-strikeable,3604,4026,4493,422,889,10389,43248,53916
Pharmacy Clerk & Technician 3,,3,Non-strikeable,3780,4216,4707,436,927,10823,45360,56484
Physical/Electronic Security Technician,,3,Non-strikeable,4337,4843,5408,506,1071,12197,52044,64896
Print Services Technician,,3,Non-strikeable,3604,4026,4493,422,889,10389,43248,53916
Printing Production Coordinator,,3,Non-strikeable,4994,5571,6232,577,1238,13817,59928,74784
Procurement & Contract Specialist 1,,3,Non-strikeable,4994,5571,6232,577,1238,13817,59928,74784
Procurement & Contract Specialist 3,,3,Non-strikeable,6505,7259,8104,754,1599,17544,78060,97248
Procurement And Contract Assistant,,3,Non-strikeable,4148,4619,5160,471,1012,11731,49776,61920
Program Analyst 1,,3,Non-strikeable,4994,5571,6232,577,1238,13817,59928,74784
Program Analyst 3,,3,Non-strikeable,6505,7259,8104,754,1599,17544,78060,97248
Psychiatric Social Worker,,3,Non-strikeable,6505,7259,8104,754,1599,17544,78060,97248
Public Affairs Specialist 2,,3,Non-strikeable,6505,7259,8104,754,1599,17544,78060,97248
Public Health Toxicologist 1,,3,Non-strikeable,6505,7259,8104,754,1599,17544,78060,97248
Public Service Representative 2,,3,Non-strikeable,3236,3551,3946,315,710,9481,38832,47352
Public Service Representative 3,,3,Non-strikeable,3477,3838,4289,361,812,10076,41724,51468
Public Service Representative 4,,3,Non-strikeable,4337,4843,5408,506,1071,12197,52044,64896
Rehabilitation Instructor For The Blind,,3,Non-strikeable,4994,5571,6232,577,1238,13817,59928,74784
Rehabilitation Instructor For The Blind (Entry),,3,Non-strikeable,4547,5076,5667,529,1120,12715,54564,68004
Research Analyst 1,,3,Non-strikeable,4148,4619,5160,471,1012,11731,49776,61920
Research Analyst 2,,3,Non-strikeable,4994,5571,6232,577,1238,13817,59928,74784
Retirement Counselor 1,,3,Non-strikeable,4337,4843,5408,506,1071,12197,52044,64896
Revenue Agent 1,,3,Non-strikeable,3780,4216,4707,436,927,10823,45360,56484
Revenue Agent 2,,3,Non-strikeable,4148,4619,5160,471,1012,11731,49776,61920
Revenue Agent 3,,3,Non-strikeable,4547,5076,5667,529,1120,12715,54564,68004
Safety Specialist 1,,3,Non-strikeable,4994,5571,6232,577,1238,13817,59928,74784
Scientific Instrument Technician,,3,Non-strikeable,4547,5076,5667,529,1120,12715,54564,68004
Seamster,,3,Non-strikeable,3477,3838,4289,361,812,10076,41724,51468
Shipping Point Inspector 1,,3,Non-strikeable,3477,3838,4289,361,812,10076,41724,51468
Shipping Point Inspector 2,,3,Non-strikeable,3780,4216,4707,436,927,10823,45360,56484
Sign Technician 1,,3,Non-strikeable,4148,4619,5160,471,1012,11731,49776,61920
Social Service Assistant,,3,Non-strikeable,3780,4216,4707,436,927,10823,45360,56484
State Library Specialist 1,,3,Non-strikeable,3114,3446,3783,332,669,9180,37368,45396
Supply Specialist 1,,3,Non-strikeable,3334,3703,4090,369,756,9723,40008,49080
Supply Specialist 2,,3,Non-strikeable,4337,4843,5408,506,1071,12197,52044,64896
Tax Auditor/Entry,,3,Non-strikeable,4337,4843,5408,506,1071,12197,52044,64896
Teaching Assistant,,3,Non-strikeable,3477,3838,4289,361,812,10076,41724,51468
Training & Development Specialist 1,,3,Non-strikeable,4994,5571,6232,577,1238,13817,59928,74784
Transportation Maintenance Coordinator 1,,3,Non-strikeable,4547,5076,5667,529,1120,12715,54564,68004
Transportation Maintenance Specialist 1,,3,Non-strikeable,3780,4216,4707,436,927,10823,45360,56484
Transportation Maintenance Specialist 2,,3,Non-strikeable,4148,4619,5160,471,1012,11731,49776,61920
Transportation Services Office Leader,,3,Non-strikeable,4547,5076,5667,529,1120,12715,54564,68004
Transportation Services Representative 1,,3,Non-strikeable,3780,4216,4707,436,927,10823,45360,56484
Transportation Services Representative 2,,3,Non-strikeable,4148,4619,5160,471,1012,11731,49776,61920
Transportation Telecommunications Specialist 1,,3,Non-strikeable,4337,4843,5408,506,1071,12197,52044,64896
Transporting Mental Health Aide,,3,Non-strikeable,3780,4216,4707,436,927,10823,45360,56484
Truck Driver 1,,3,Non-strikeable,3780,4216,4707,436,927,10823,45360,56484
Truck Driver 2,,3,Non-strikeable,4337,4843,5408,506,1071,12197,52044,64896
Veterans Service Officer,,3,Non-strikeable,4994,5571,6232,577,1238,13817,59928,74784
Veterans Trust Officer,,3,Non-strikeable,4994,5571,6232,577,1238,13817,59928,74784
Vocational Rehabilitation Counselor Entry,,3,Non-strikeable,4337,4843,5408,506,1071,12197,52044,64896
Water Resource Data Technician 1,,3,Non-strikeable,4148,4619,5160,471,1012,11731,49776,61920
Water Resource Data Technician 2,,3,Non-strikeable,4547,5076,5667,529,1120,12715,54564,68004
Wildland Fire Dispatcher,,3,Non-strikeable,3477,3838,4289,361,812,10076,41724,51468
Wildland Fire Dispatcher Entry,,3,Non-strikeable,3009,3446,3783,437,774,8921,36108,45396
Wildland Fire Suppression Specialist,,3,Non-strikeable,3780,4216,4707,436,927,10823,45360,56484
Wildland Fire Suppression Specialist Entry,,3,Non-strikeable,3236,3551,3946,315,710,9481,38832,47352
Word Processing Technician 2,,3,Non-strikeable,3334,3703,4090,369,756,9723,40008,49080
Word Processing Technician 3,,3,Non-strikeable,3604,4026,4493,422,889,10389,43248,53916
Youth Corrections Unit Coordinator,,3,Non-strikeable,4994,5571,6232,577,1238,13817,59928,74784
Accountant 1,,4,Non-strikeable,5231,5571,5936,340,705,14402,62772,71232
Accounting Technician,,4,Non-strikeable,4337,4843,5408,506,1071,12197,52044,64896
Activities Coordinator,,4,Non-strikeable,4337,4843,5408,506,1071,12197,52044,64896
Administrative Specialist 1,,4,Non-strikeable,3959,4418,4921,459,962,11265,47508,59052
Administrative Specialist 2,,4,Non-strikeable,4547,5076,5667,529,1120,12715,54564,68004
Apprenticeship Representative,,4,Non-strikeable,5231,5849,6529,618,1298,14402,62772,78348
Automotive Fleet Attendant,,4,Non-strikeable,3477,3838,4289,361,812,10076,41724,51468
Automotive Technician 1,,4,Non-strikeable,4337,4843,5408,506,1071,12197,52044,64896
Automotive Technician 2,,4,Non-strikeable,5231,5849,6529,618,1298,14402,62772,78348
Behavioral Health Specialist 3,,4,Non-strikeable,6816,7606,8493,790,1677,18311,81792,101916
Biological Science Assistant,,4,Non-strikeable,3236,3551,3946,315,710,9481,38832,47352
Business & Employment Specialist 2,,4,Non-strikeable,4766,5319,5936,553,1170,13255,57192,71232
Certified Occupation Therapist Assistant,,4,Non-strikeable,4547,5076,5667,529,1120,12715,54564,68004
Chemist 3,,4,Non-strikeable,6816,7606,8493,790,1677,18311,81792,101916
Child Support Case Manager,,4,Non-strikeable,4766,5319,5936,553,1170,13255,57192,71232
Child Support Case Manager Entry,,4,Non-strikeable,4337,4843,5408,506,1071,12197,52044,64896
Child Support Specialist,,4,Non-strikeable,5231,5849,6529,618,1298,14402,62772,78348
Civil Rights Investigator 1,,4,Non-strikeable,4766,5319,5936,553,1170,13255,57192,71232
Compliance Specialist 1,,4,Non-strikeable,4766,5319,5936,553,1170,13255,57192,71232
Compliance Specialist 3,,4,Non-strikeable,6816,7606,8493,790,1677,18311,81792,101916
Cook,,4,Non-strikeable,3959,4418,4921,459,962,11265,47508,59052
Custodial Services Coordinator,,4,Non-strikeable,3334,3703,4090,369,756,9723,40008,49080
Data Entry Control Technician,,4,Non-strikeable,3236,3551,3946,315,710,9481,38832,47352
Data Entry Operator,,4,Non-strikeable,3236,3551,3946,315,710,9481,38832,47352
Dental Assistant 2,,4,Non-strikeable,4547,5076,5667,529,1120,12715,54564,68004
Dental Hygienist,,4,Non-strikeable,6816,7606,8493,790,1677,18311,81792,101916
Disability Analyst 1,,4,Non-strikeable,5231,5849,6529,618,1298,14402,62772,78348
District Veterinarian,,4,Non-strikeable,6816,7606,8493,790,1677,18311,81792,101916
Dormitory Counselor 1,,4,Non-strikeable,3780,4216,4707,436,927,10823,45360,56484
Dormitory Counselor 2,,4,Non-strikeable,4547,5076,5667,529,1120,12715,54564,68004
Economist 1,,4,Non-strikeable,5231,5849,6529,618,1298,14402,62772,78348
Electronic Publishing Design Specialist 1,,4,Non-strikeable,3959,4418,4921,459,962,11265,47508,59052
Employment Adjudicator,,4,Non-strikeable,5231,5849,6529,618,1298,14402,62772,78348
Employment Appeals Board Legal Staff,,4,Non-strikeable,6816,7606,8493,790,1677,18311,81792,101916
Engineering Technician 2,,4,Non-strikeable,4337,4843,5408,506,1071,12197,52044,64896
Engineering Technician 3,,4,Non-strikeable,4766,5319,5936,553,1170,13255,57192,71232
Equipment Operator,,4,Non-strikeable,4766,5319,5936,553,1170,13255,57192,71232
Executive Support Specialist 1,,4,Non-strikeable,3959,4418,4921,459,962,11265,47508,59052
Executive Support Specialist 2,,4,Non-strikeable,4547,5076,5667,529,1120,12715,54564,68004
Facility Energy Technician 4,,4,Non-strikeable,6816,7606,8493,790,1677,18311,81792,101916
Fiscal Analyst 1,,4,Non-strikeable,5231,5849,6529,618,1298,14402,62772,78348
Fiscal Auditor 1,,4,Non-strikeable,5231,5849,6529,618,1298,14402,62772,78348
Fish and Wildlife Technical Coordinator,,4,Non-strikeable,4766,5319,5936,553,1170,13255,57192,71232
Fish and Wildlife Technician,,4,Non-strikeable,3959,4418,4921,459,962,11265,47508,59052
Fish and Wildlife Technician Entry,,4,Non-strikeable,3334,3703,4090,369,756,9723,40008,49080
Fish and Wildlife Technician Senior,,4,Non-strikeable,4337,4843,5408,506,1071,12197,52044,64896
Food Service Worker,,4,Non-strikeable,3334,3703,4090,369,756,9723,40008,49080
Forest Crew Coordinator,,4,Non-strikeable,4337,4843,5408,506,1071,12197,52044,64896
Forest Lookout,,4,Non-strikeable,3114,3446,3783,332,669,9180,37368,45396
Forest Management Technician,,4,Non-strikeable,3780,4216,4707,436,927,10823,45360,56484
Forest Officer,,4,Non-strikeable,5231,5849,6529,618,1298,14402,62772,78348
Governmental Auditor 3,,4,Non-strikeable,6816,7606,8493,790,1677,18311,81792,101916
Grounds Maintenance Worker 1,,4,Non-strikeable,3477,3838,4289,361,812,10076,41724,51468
Grounds Maintenance Worker 2,,4,Non-strikeable,3959,4418,4921,459,962,11265,47508,59052
Group Life Coordinator 1,,4,Non-strikeable,3604,4026,4493,422,889,10389,43248,53916
Group Life Coordinator 2,,4,Non-strikeable,4337,4843,5408,506,1071,12197,52044,64896
Human Services Assistant 2,,4,Non-strikeable,3780,4216,4707,436,927,10823,45360,56484
Human Services Case Manager,,4,Non-strikeable,4766,5319,5936,553,1170,13255,57192,71232
Human Services Specialist 1,,4,Non-strikeable,3604,4026,4493,422,889,10389,43248,53916
Human Services Specialist 2,,4,Non-strikeable,3959,4418,4921,459,962,11265,47508,59052
Human Services Specialist 3,,4,Non-strikeable,4337,4843,5408,506,1071,12197,52044,64896
Incident Response Operations Specialist,,4,Non-strikeable,4547,5076,5667,529,1120,12715,54564,68004
Industrial Hygienist 3,,4,Non-strikeable,6816,7606,8493,790,1677,18311,81792,101916
Information Systems Specialist 2,,4,Non-strikeable,4766,5319,5936,553,1170,13255,57192,71232
Information Systems Specialist 6,,4,Non-strikeable,6816,7606,8493,790,1677,18311,81792,101916
Information Systems Specialist 7,,4,Non-strikeable,6816,7606,8493,790,1677,18311,81792,101916
Investigator 1,,4,Non-strikeable,4337,4843,5408,506,1071,12197,52044,64896
Investigator 2,,4,Non-strikeable,5231,5849,6529,618,1298,14402,62772,78348
Laboratory Technician 2,,4,Non-strikeable,3959,4418,4921,459,962,11265,47508,59052
Laborer/Student Worker,,4,Non-strikeable,3236,3551,3946,315,710,9481,38832,47352
Licensed Practical Nurse,,4,Non-strikeable,4747,5297,5926,550,1179,13208,56964,71112
Livestock Brand Inspector,,4,Non-strikeable,3604,4026,4493,422,889,10389,43248,53916
Loan Specialist 1,,4,Non-strikeable,5231,5849,6529,618,1298,14402,62772,78348
Mail Delivery Driver,,4,Non-strikeable,3604,4026,4493,422,889,10389,43248,53916
Mail Equipment Operator 1,,4,Non-strikeable,3236,3551,3946,315,710,9481,38832,47352
Mail Equipment Operator 2,,4,Non-strikeable,3604,4026,4493,422,889,10389,43248,53916
Mail Services Assistant,,4,Non-strikeable,3334,3703,4090,369,756,9723,40008,49080
Manual Arts Instructor,,4,Non-strikeable,3959,4418,4921,459,962,11265,47508,59052
Medical Laboratory Technician 2,,4,Non-strikeable,4547,5076,5667,529,1120,12715,54564,68004
Mental Health Security Technician,,4,Non-strikeable,3959,4418,4921,459,962,11265,47508,59052
Mental Health Therapist 1,,4,Non-strikeable,3959,4418,4921,459,962,11265,47508,59052
Mental Health Therapist 2,,4,Non-strikeable,4337,4843,5408,506,1071,12197,52044,64896
Mental Health Therapy Coordinator,,4,Non-strikeable,4337,4843,5408,506,1071,12197,52044,64896
Mental Health Therapy Technician,,4,Non-strikeable,3604,4026,4493,422,889,10389,43248,53916
Microbiologist 1,,4,Non-strikeable,5231,5849,6529,618,1298,14402,62772,78348
Motor Carrier Enforcement Officer 1,,4,Non-strikeable,4766,5319,5936,553,1170,13255,57192,71232
Natural Resource Specialist 1,,4,Non-strikeable,4766,5319,5936,553,1170,13255,57192,71232
Nutrition Consultant,,4,Non-strikeable,6816,7606,8493,790,1677,18311,81792,101916
Occupational Safety Specialist 3,,4,Non-strikeable,6816,7606,8493,790,1677,18311,81792,101916
Office Coordinator,,4,Non-strikeable,3604,4026,4493,422,889,10389,43248,53916
Office Specialist 1,,4,Non-strikeable,3334,3703,4090,369,756,9723,40008,49080
Office Specialist 2,,4,Non-strikeable,3604,4026,4493,422,889,10389,43248,53916
Operations & Policy Analyst 1,,4,Non-strikeable,5231,5849,6529,618,1298,14402,62772,78348
Park Ranger 2,,4,Non-strikeable,4547,5076,5667,529,1120,12715,54564,68004
Park Ranger Assistant,,4,Non-strikeable,3236,3551,3946,315,710,9481,38832,47352
Park Specialist,,4,Non-strikeable,3959,4418,4921,459,962,11265,47508,59052
Parking Services Representative,,4,Non-strikeable,3477,3838,4289,361,812,10076,41724,51468
Parts Specialist 2,,4,Non-strikeable,4547,5076,5667,529,1120,12715,54564,68004
Payroll Analyst,,4,Non-strikeable,4766,5319,5936,553,1170,13255,57192,71232
Pharmacist Resident,,4,Non-strikeable,5231,5849,6529,618,1298,14402,62772,78348
Pharmacy Clerk & Technician 2,,4,Non-strikeable,3780,4216,4707,436,927,10823,45360,56484
Pharmacy Clerk & Technician 3,,4,Non-strikeable,3959,4418,4921,459,962,11265,47508,59052
Physical/Electronic Security Technician,,4,Non-strikeable,4547,5076,5667,529,1120,12715,54564,68004
Print Services Technician,,4,Non-strikeable,3780,4216,4707,436,927,10823,45360,56484
Printing Production Coordinator,,4,Non-strikeable,5231,5849,6529,618,1298,14402,62772,78348
Procurement & Contract Specialist 1,,4,Non-strikeable,5231,5849,6529,618,1298,14402,62772,78348
Procurement & Contract Specialist 3,,4,Non-strikeable,6816,7606,8493,790,1677,18311,81792,101916
Procurement And Contract Assistant,,4,Non-strikeable,4337,4843,5408,506,1071,12197,52044,64896
Program Analyst 1,,4,Non-strikeable,5231,5849,6529,618,1298,14402,62772,78348
Program Analyst 3,,4,Non-strikeable,6816,7606,8493,790,1677,18311,81792,101916
Psychiatric Social Worker,,4,Non-strikeable,6816,7606,8493,790,1677,18311,81792,101916
Public Affairs Specialist 2,,4,Non-strikeable,6816,7606,8493,790,1677,18311,81792,101916
Public Health Toxicologist 1,,4,Non-strikeable,6816,7606,8493,790,1677,18311,81792,101916
Public Service Representative 2,,4,Non-strikeable,3334,3703,4090,369,756,9723,40008,49080
Public Service Representative 3,,4,Non-strikeable,3604,4026,4493,422,889,10389,43248,53916
Public Service Representative 4,,4,Non-strikeable,4547,5076,5667,529,1120,12715,54564,68004
Rehabilitation Instructor For The Blind,,4,Non-strikeable,5231,5849,6529,618,1298,14402,62772,78348
Rehabilitation Instructor For The Blind (Entry),,4,Non-strikeable,4766,5319,5936,553,1170,13255,57192,71232
Research Analyst 1,,4,Non-strikeable,4337,4843,5408,506,1071,12197,52044,64896
Research Analyst 2,,4,Non-strikeable,5231,5849,6529,618,1298,14402,62772,78348
Retirement Counselor 1,,4,Non-strikeable,4547,5076,5667,529,1120,12715,54564,68004
Revenue Agent 1,,4,Non-strikeable,3959,4418,4921,459,962,11265,47508,59052
Revenue Agent 2,,4,Non-strikeable,4337,4843,5408,506,1071,12197,52044,64896
Revenue Agent 3,,4,Non-strikeable,4766,5319,5936,553,1170,13255,57192,71232
Safety Specialist 1,,4,Non-strikeable,5231,5849,6529,618,1298,14402,62772,78348
Scientific Instrument Technician,,4,Non-strikeable,4766,5319,5936,553,1170,13255,57192,71232
Seamster,,4,Non-strikeable,3604,4026,4493,422,889,10389,43248,53916
Shipping Point Inspector 1,,4,Non-strikeable,3604,4026,4493,422,889,10389,43248,53916
Shipping Point Inspector 2,,4,Non-strikeable,3959,4418,4921,459,962,11265,47508,59052
Sign Technician 1,,4,Non-strikeable,4337,4843,5408,506,1071,12197,52044,64896
Social Service Assistant,,4,Non-strikeable,3959,4418,4921,459,962,11265,47508,59052
State Library Specialist 1,,4,Non-strikeable,3236,3551,3946,315,710,9481,38832,47352
Supply Specialist 1,,4,Non-strikeable,3477,3838,4289,361,812,10076,41724,51468
Supply Specialist 2,,4,Non-strikeable,4547,5076,5667,529,1120,12715,54564,68004
Tax Auditor/Entry,,4,Non-strikeable,4547,5076,5667,529,1120,12715,54564,68004
Teaching Assistant,,4,Non-strikeable,3604,4026,4493,422,889,10389,43248,53916
Training & Development Specialist 1,,4,Non-strikeable,5231,5849,6529,618,1298,14402,62772,78348
Transportation Maintenance Coordinator 1,,4,Non-strikeable,4766,5319,5936,553,1170,13255,57192,71232
Transportation Maintenance Specialist 1,,4,Non-strikeable,3959,4418,4921,459,962,11265,47508,59052
Transportation Maintenance Specialist 2,,4,Non-strikeable,4337,4843,5408,506,1071,12197,52044,64896
Transportation Services Office Leader,,4,Non-strikeable,4766,5319,5936,553,1170,13255,57192,71232
Transportation Services Representative 1,,4,Non-strikeable,3959,4418,4921,459,962,11265,47508,59052
Transportation Services Representative 2,,4,Non-strikeable,4337,4843,5408,506,1071,12197,52044,64896
Transportation Telecommunications Specialist 1,,4,Non-strikeable,4547,5076,5667,529,1120,12715,54564,68004
Transporting Mental Health Aide,,4,Non-strikeable,3959,4418,4921,459,962,11265,47508,59052
Truck Driver 1,,4,Non-strikeable,3959,4418,4921,459,962,11265,47508,59052
Truck Driver 2,,4,Non-strikeable,4547,5076,5667,529,1120,12715,54564,68004
Veterans Service Officer,,4,Non-strikeable,5231,5849,6529,618,1298,14402,62772,78348
Veterans Trust Officer,,4,Non-strikeable,5231,5849,6529,618,1298,14402,62772,78348
Vocational Rehabilitation Counselor Entry,,4,Non-strikeable,4547,5076,5667,529,1120,12715,54564,68004
Water Resource Data Technician 1,,4,Non-strikeable,4337,4843,5408,506,1071,12197,52044,64896
Water Resource Data Technician 2,,4,Non-strikeable,4766,5319,5936,553,1170,13255,57192,71232
Wildland Fire Dispatcher,,4,Non-strikeable,3604,4026,4493,422,889,10389,43248,53916
Wildland Fire Dispatcher Entry,,4,Non-strikeable,3114,3446,3783,332,669,9180,37368,45396
Wildland Fire Suppression Specialist,,4,Non-strikeable,3959,4418,4921,459,962,11265,47508,59052
Wildland Fire Suppression Specialist Entry,,4,Non-strikeable,3334,3703,4090,369,756,9723,40008,49080
Word Processing Technician 2,,4,Non-strikeable,3477,3838,4289,361,812,10076,41724,51468
Word Processing Technician 3,,4,Non-strikeable,3780,4216,4707,436,927,10823,45360,56484
Youth Corrections Unit Coordinator,,4,Non-strikeable,5231,5849,6529,618,1298,14402,62772,78348
Accountant 1,,5,Non-strikeable,5492,5849,6232,357,740,15046,65904,74784
Accounting Technician,,5,Non-strikeable,4547,5076,5667,529,1120,12715,54564,68004
Activities Coordinator,,5,Non-strikeable,4547,5076,5667,529,1120,12715,54564,68004
Administrative Specialist 1,,5,Non-strikeable,4148,4619,5160,471,1012,11731,49776,61920
Administrative Specialist 2,,5,Non-strikeable,4766,5319,5936,553,1170,13255,57192,71232
Apprenticeship Representative,,5,Non-strikeable,5492,6128,6844,636,1352,15046,65904,82128
Automotive Fleet Attendant,,5,Non-strikeable,3604,4026,4493,422,889,10389,43248,53916
Automotive Technician 1,,5,Non-strikeable,4547,5076,5667,529,1120,12715,54564,68004
Automotive Technician 2,,5,Non-strikeable,5492,6128,6844,636,1352,15046,65904,82128
Behavioral Health Specialist 3,,5,Non-strikeable,7142,7970,8902,828,1760,19115,85704,106824
Biological Science Assistant,,5,Non-strikeable,3334,3703,4090,369,756,9723,40008,49080
Business & Employment Specialist 2,,5,Non-strikeable,4994,5571,6232,577,1238,13817,59928,74784
Certified Occupation Therapist Assistant,,5,Non-strikeable,4766,5319,5936,553,1170,13255,57192,71232
Chemist 3,,5,Non-strikeable,7142,7970,8902,828,1760,19115,85704,106824
Child Support Case Manager,,5,Non-strikeable,4994,5571,6232,577,1238,13817,59928,74784
Child Support Case Manager Entry,,5,Non-strikeable,4547,5076,5667,529,1120,12715,54564,68004
Child Support Specialist,,5,Non-strikeable,5492,6128,6844,636,1352,15046,65904,82128
Civil Rights Investigator 1,,5,Non-strikeable,4994,5571,6232,577,1238,13817,59928,74784
Compliance Specialist 1,,5,Non-strikeable,4994,5571,6232,577,1238,13817,59928,74784
Compliance Specialist 3,,5,Non-strikeable,7142,7970,8902,828,1760,19115,85704,106824
Cook,,5,Non-strikeable,4148,4619,5160,471,1012,11731,49776,61920
Custodial Services Coordinator,,5,Non-strikeable,3477,3838,4289,361,812,10076,41724,51468
Data Entry Control Technician,,5,Non-strikeable,3334,3703,4090,369,756,9723,40008,49080
Data Entry Operator,,5,Non-strikeable,3334,3703,4090,369,756,9723,40008,49080
Dental Assistant 2,,5,Non-strikeable,4766,5319,5936,553,1170,13255,57192,71232
Dental Hygienist,,5,Non-strikeable,7142,7970,8902,828,1760,19115,85704,106824
Disability Analyst 1,,5,Non-strikeable,5492,6128,6844,636,1352,15046,65904,82128
District Veterinarian,,5,Non-strikeable,7142,7970,8902,828,1760,19115,85704,106824
Dormitory Counselor 1,,5,Non-strikeable,3959,4418,4921,459,962,11265,47508,59052
Dormitory Counselor 2,,5,Non-strikeable,4766,5319,5936,553,1170,13255,57192,71232
Economist 1,,5,Non-strikeable,5492,6128,6844,636,1352,15046,65904,82128
Electronic Publishing Design Specialist 1,,5,Non-strikeable,4148,4619,5160,471,1012,11731,49776,61920
Employment Adjudicator,,5,Non-strikeable,5492,6128,6844,636,1352,15046,65904,82128
Employment Appeals Board Legal Staff,,5,Non-strikeable,7142,7970,8902,828,1760,19115,85704,106824
Engineering Technician 2,,5,Non-strikeable,4547,5076,5667,529,1120,12715,54564,68004
Engineering Technician 3,,5,Non-strikeable,4994,5571,6232,577,1238,13817,59928,74784
Equipment Operator,,5,Non-strikeable,4994,5571,6232,577,1238,13817,59928,74784
Executive Support Specialist 1,,5,Non-strikeable,4148,4619,5160,471,1012,11731,49776,61920
Executive Support Specialist 2,,5,Non-strikeable,4766,5319,5936,553,1170,13255,57192,71232
Facility Energy Technician 4,,5,Non-strikeable,7142,7970,8902,828,1760,19115,85704,106824
Fiscal Analyst 1,,5,Non-strikeable,5492,6128,6844,636,1352,15046,65904,82128
Fiscal Auditor 1,,5,Non-strikeable,5492,6128,6844,636,1352,15046,65904,82128
Fish and Wildlife Technical Coordinator,,5,Non-strikeable,4994,5571,6232,577,1238,13817,59928,74784
Fish and Wildlife Technician,,5,Non-strikeable,4148,4619,5160,471,1012,11731,49776,61920
Fish and Wildlife Technician Entry,,5,Non-strikeable,3477,3838,4289,361,812,10076,41724,51468
Fish and Wildlife Technician Senior,,5,Non-strikeable,4547,5076,5667,529,1120,12715,54564,68004
Food Service Worker,,5,Non-strikeable,3477,3838,4289,361,812,10076,41724,51468
Forest Crew Coordinator,,5,Non-strikeable,4547,5076,5667,529,1120,12715,54564,68004
Forest Lookout,,5,Non-strikeable,3236,3551,3946,315,710,9481,38832,47352
Forest Management Technician,,5,Non-strikeable,3959,4418,4921,459,962,11265,47508,59052
Forest Officer,,5,Non-strikeable,5492,6128,6844,636,1352,15046,65904,82128
Governmental Auditor 3,,5,Non-strikeable,7142,7970,8902,828,1760,19115,85704,106824
Grounds Maintenance Worker 1,,5,Non-strikeable,3604,4026,4493,422,889,10389,43248,53916
Grounds Maintenance Worker 2,,5,Non-strikeable,4148,4619,5160,471,1012,11731,49776,61920
Group Life Coordinator 1,,5,Non-strikeable,3780,4216,4707,436,927,10823,45360,56484
Group Life Coordinator 2,,5,Non-strikeable,4547,5076,5667,529,1120,12715,54564,68004
Human Services Assistant 2,,5,Non-strikeable,3959,4418,4921,459,962,11265,47508,59052
Human Services Case Manager,,5,Non-strikeable,4994,5571,6232,577,1238,13817,59928,74784
Human Services Specialist 1,,5,Non-strikeable,3780,4216,4707,436,927,10823,45360,56484
Human Services Specialist 2,,5,Non-strikeable,4148,4619,5160,471,1012,11731,49776,61920
Human Services Specialist 3,,5,Non-strikeable,4547,5076,5667,529,1120,12715,54564,68004
Incident Response Operations Specialist,,5,Non-strikeable,4766,5319,5936,553,1170,13255,57192,71232
Industrial Hygienist 3,,5,Non-strikeable,7142,7970,8902,828,1760,19115,85704,106824
Information Systems Specialist 2,,5,Non-strikeable,4994,5571,6232,577,1238,13817,59928,74784
Information Systems Specialist 6,,5,Non-strikeable,7142,7970,8902,828,1760,19115,85704,106824
Information Systems Specialist 7,,5,Non-strikeable,7142,7970,8902,828,1760,19115,85704,106824
Investigator 1,,5,Non-strikeable,4547,5076,5667,529,1120,12715,54564,68004
Investigator 2,,5,Non-strikeable,5492,6128,6844,636,1352,15046,65904,82128
Laboratory Technician 2,,5,Non-strikeable,4148,4619,5160,471,1012,11731,49776,61920
Laborer/Student Worker,,5,Non-strikeable,3334,3703,4090,369,756,9723,40008,49080
Licensed Practical Nurse,,5,Non-strikeable,4974,5561,5948,587,974,13768,59688,71376
Livestock Brand Inspector,,5,Non-strikeable,3780,4216,4707,436,927,10823,45360,56484
Loan Specialist 1,,5,Non-strikeable,5492,6128,6844,636,1352,15046,65904,82128
Mail Delivery Driver,,5,Non-strikeable,3780,4216,4707,436,927,10823,45360,56484
Mail Equipment Operator 1,,5,Non-strikeable,3334,3703,4090,369,756,9723,40008,49080
Mail Equipment Operator 2,,5,Non-strikeable,3780,4216,4707,436,927,10823,45360,56484
Mail Services Assistant,,5,Non-strikeable,3477,3838,4289,361,812,10076,41724,51468
Manual Arts Instructor,,5,Non-strikeable,4148,4619,5160,471,1012,11731,49776,61920
Medical Laboratory Technician 2,,5,Non-strikeable,4766,5319,5936,553,1170,13255,57192,71232
Mental Health Security Technician,,5,Non-strikeable,4148,4619,5160,471,1012,11731,49776,61920
Mental Health Therapist 1,,5,Non-strikeable,4148,4619,5160,471,1012,11731,49776,61920
Mental Health Therapist 2,,5,Non-strikeable,4547,5076,5667,529,1120,12715,54564,68004
Mental Health Therapy Coordinator,,5,Non-strikeable,4547,5076,5667,529,1120,12715,54564,68004
Mental Health Therapy Technician,,5,Non-strikeable,3780,4216,4707,436,927,10823,45360,56484
Microbiologist 1,,5,Non-strikeable,5492,6128,6844,636,1352,15046,65904,82128
Motor Carrier Enforcement Officer 1,,5,Non-strikeable,4994,5571,6232,577,1238,13817,59928,74784
Natural Resource Specialist 1,,5,Non-strikeable,4994,5571,6232,577,1238,13817,59928,74784
Nutrition Consultant,,5,Non-strikeable,7142,7970,8902,828,1760,19115,85704,106824
Occupational Safety Specialist 3,,5,Non-strikeable,7142,7970,8902,828,1760,19115,85704,106824
Office Coordinator,,5,Non-strikeable,3780,4216,4707,436,927,10823,45360,56484
Office Specialist 1,,5,Non-strikeable,3477,3838,4289,361,812,10076,41724,51468
Office Specialist 2,,5,Non-strikeable,3780,4216,4707,436,927,10823,45360,56484
Operations & Policy Analyst 1,,5,Non-strikeable,5492,6128,6844,636,1352,15046,65904,82128
Park Ranger 2,,5,Non-strikeable,4766,5319,5936,553,1170,13255,57192,71232
Park Ranger Assistant,,5,Non-strikeable,3334,3703,4090,369,756,9723,40008,49080
Park Specialist,,5,Non-strikeable,4148,4619,5160,471,1012,11731,49776,61920
Parking Services Representative,,5,Non-strikeable,3604,4026,4493,422,889,10389,43248,53916
Parts Specialist 2,,5,Non-strikeable,4766,5319,5936,553,1170,13255,57192,71232
Payroll Analyst,,5,Non-strikeable,4994,5571,6232,577,1238,13817,59928,74784
Pharmacist Resident,,5,Non-strikeable,5492,6128,6844,636,1352,15046,65904,82128
Pharmacy Clerk & Technician 2,,5,Non-strikeable,3959,4418,4921,459,962,11265,47508,59052
Pharmacy Clerk & Technician 3,,5,Non-strikeable,4148,4619,5160,471,1012,11731,49776,61920
Physical/Electronic Security Technician,,5,Non-strikeable,4766,5319,5936,553,1170,13255,57192,71232
Print Services Technician,,5,Non-strikeable,3959,4418,4921,459,962,11265,47508,59052
Printing Production Coordinator,,5,Non-strikeable,5492,6128,6844,636,1352,15046,65904,82128
Procurement & Contract Specialist 1,,5,Non-strikeable,5492,6128,6844,636,1352,15046,65904,82128
Procurement & Contract Specialist 3,,5,Non-strikeable,7142,7970,8902,828,1760,19115,85704,106824
Procurement And Contract Assistant,,5,Non-strikeable,4547,5076,5667,529,1120,12715,54564,68004
Program Analyst 1,,5,Non-strikeable,5492,6128,6844,636,1352,15046,65904,82128
Program Analyst 3,,5,Non-strikeable,7142,7970,8902,828,1760,19115,85704,106824
Psychiatric Social Worker,,5,Non-strikeable,7142,7970,8902,828,1760,19115,85704,106824
Public Affairs Specialist 2,,5,Non-strikeable,7142,7970,8902,828,1760,19115,85704,106824
Public Health Toxicologist 1,,5,Non-strikeable,7142,7970,8902,828,1760,19115,85704,106824
Public Service Representative 2,,5,Non-strikeable,3477,3838,4289,361,812,10076,41724,51468
Public Service Representative 3,,5,Non-strikeable,3780,4216,4707,436,927,10823,45360,56484
Public Service Representative 4,,5,Non-strikeable,4766,5319,5936,553,1170,13255,57192,71232
Rehabilitation Instructor For The Blind,,5,Non-strikeable,5492,6128,6844,636,1352,15046,65904,82128
Rehabilitation Instructor For The Blind (Entry),,5,Non-strikeable,4994,5571,6232,577,1238,13817,59928,74784
Research Analyst 1,,5,Non-strikeable,4547,5076,5667,529,1120,12715,54564,68004
Research Analyst 2,,5,Non-strikeable,5492,6128,6844,636,1352,15046,65904,82128
Retirement Counselor 1,,5,Non-strikeable,4766,5319,5936,553,1170,13255,57192,71232
Revenue Agent 1,,5,Non-strikeable,4148,4619,5160,471,1012,11731,49776,61920
Revenue Agent 2,,5,Non-strikeable,4547,5076,5667,529,1120,12715,54564,68004
Revenue Agent 3,,5,Non-strikeable,4994,5571,6232,577,1238,13817,59928,74784
Safety Specialist 1,,5,Non-strikeable,5492,6128,6844,636,1352,15046,65904,82128
Scientific Instrument Technician,,5,Non-strikeable,4994,5571,6232,577,1238,13817,59928,74784
Seamster,,5,Non-strikeable,3780,4216,4707,436,927,10823,45360,56484
Shipping Point Inspector 1,,5,Non-strikeable,3780,4216,4707,436,927,10823,45360,56484
Shipping Point Inspector 2,,5,Non-strikeable,4148,4619,5160,471,1012,11731,49776,61920
Sign Technician 1,,5,Non-strikeable,4547,5076,5667,529,1120,12715,54564,68004
Social Service Assistant,,5,Non-strikeable,4148,4619,5160,471,1012,11731,49776,61920
State Library Specialist 1,,5,Non-strikeable,3334,3703,4090,369,756,9723,40008,49080
Supply Specialist 1,,5,Non-strikeable,3604,4026,4493,422,889,10389,43248,53916
Supply Specialist 2,,5,Non-strikeable,4766,5319,5936,553,1170,13255,57192,71232
Tax Auditor/Entry,,5,Non-strikeable,4766,5319,5936,553,1170,13255,57192,71232
Teaching Assistant,,5,Non-strikeable,3780,4216,4707,436,927,10823,45360,56484
Training & Development Specialist 1,,5,Non-strikeable,5492,6128,6844,636,1352,15046,65904,82128
Transportation Maintenance Coordinator 1,,5,Non-strikeable,4994,5571,6232,577,1238,13817,59928,74784
Transportation Maintenance Specialist 1,,5,Non-strikeable,4148,4619,5160,471,1012,11731,49776,61920
Transportation Maintenance Specialist 2,,5,Non-strikeable,4547,5076,5667,529,1120,12715,54564,68004
Transportation Services Office Leader,,5,Non-strikeable,4994,5571,6232,577,1238,13817,59928,74784
Transportation Services Representative 1,,5,Non-strikeable,4148,4619,5160,471,1012,11731,49776,61920
Transportation Services Representative 2,,5,Non-strikeable,4547,5076,5667,529,1120,12715,54564,68004
Transportation Telecommunications Specialist 1,,5,Non-strikeable,4766,5319,5936,553,1170,13255,57192,71232
Transporting Mental Health Aide,,5,Non-strikeable,4148,4619,5160,471,1012,11731,49776,61920
Truck Driver 1,,5,Non-strikeable,4148,4619,5160,471,1012,11731,49776,61920
Truck Driver 2,,5,Non-strikeable,4766,5319,5936,553,1170,13255,57192,71232
Veterans Service Officer,,5,Non-strikeable,5492,6128,6844,636,1352,15046,65904,82128
Veterans Trust Officer,,5,Non-strikeable,5492,6128,6844,636,1352,15046,65904,82128
Vocational Rehabilitation Counselor Entry,,5,Non-strikeable,4766,5319,5936,553,1170,13255,57192,71232
Water Resource Data Technician 1,,5,Non-strikeable,4547,5076,5667,529,1120,12715,54564,68004
Water Resource Data Technician 2,,5,Non-strikeable,4994,5571,6232,577,1238,13817,59928,74784
Wildland Fire Dispatcher,,5,Non-strikeable,3780,4216,4707,436,927,10823,45360,56484
Wildland Fire Dispatcher Entry,,5,Non-strikeable,3236,3551,3946,315,710,9481,38832,47352
Wildland Fire Suppression Specialist,,5,Non-strikeable,4148,4619,5160,471,1012,11731,49776,61920
Wildland Fire Suppression Specialist Entry,,5,Non-strikeable,3477,3838,4289,361,812,10076,41724,51468
Word Processing Technician 2,,5,Non-strikeable,3604,4026,4493,422,889,10389,43248,53916
Word Processing Technician 3,,5,Non-strikeable,3959,4418,4921,459,962,11265,47508,59052
Youth Corrections Unit Coordinator,,5,Non-strikeable,5492,6128,6844,636,1352,15046,65904,82128
Accountant 1,,6,Non-strikeable,5754,6128,6529,374,775,15692,69048,78348
Accounting Technician,,6,Non-strikeable,4766,5319,5936,553,1170,13255,57192,71232
Activities Coordinator,,6,Non-strikeable,4766,5319,5936,553,1170,13255,57192,71232
Administrative Specialist 1,,6,Non-strikeable,4337,4843,5408,506,1071,12197,52044,64896
Administrative Specialist 2,,6,Non-strikeable,4994,5571,6232,577,1238,13817,59928,74784
Apprenticeship Representative,,6,Non-strikeable,5754,6423,7169,669,1415,15692,69048,86028
Automotive Fleet Attendant,,6,Non-strikeable,3780,4216,4707,436,927,10823,45360,56484
Automotive Technician 1,,6,Non-strikeable,4766,5319,5936,553,1170,13255,57192,71232
Automotive Technician 2,,6,Non-strikeable,5754,6423,7169,669,1415,15692,69048,86028
Behavioral Health Specialist 3,,6,Non-strikeable,7484,8355,9328,871,1844,19959,89808,111936
Biological Science Assistant,,6,Non-strikeable,3477,3838,4289,361,812,10076,41724,51468
Business & Employment Specialist 2,,6,Non-strikeable,5231,5849,6529,618,1298,14402,62772,78348
Certified Occupation Therapist Assistant,,6,Non-strikeable,4994,5571,6232,577,1238,13817,59928,74784
Chemist 3,,6,Non-strikeable,7484,8355,9328,871,1844,19959,89808,111936
Child Support Case Manager,,6,Non-strikeable,5231,5849,6529,618,1298,14402,62772,78348
Child Support Case Manager Entry,,6,Non-strikeable,4766,5319,5936,553,1170,13255,57192,71232
Child Support Specialist,,6,Non-strikeable,5754,6423,7169,669,1415,15692,69048,86028
Civil Rights Investigator 1,,6,Non-strikeable,5231,5849,6529,618,1298,14402,62772,78348
Compliance Specialist 1,,6,Non-strikeable,5231,5849,6529,618,1298,14402,62772,78348
Compliance Specialist 3,,6,Non-strikeable,7484,8355,9328,871,1844,19959,89808,111936
Cook,,6,Non-strikeable,4337,4843,5408,506,1071,12197,52044,64896
Custodial Services Coordinator,,6,Non-strikeable,3604,4026,4493,422,889,10389,43248,53916
Data Entry Control Technician,,6,Non-strikeable,3477,3838,4289,361,812,10076,41724,51468
Data Entry Operator,,6,Non-strikeable,3477,3838,4289,361,812,10076,41724,51468
Dental Assistant 2,,6,Non-strikeable,4994,5571,6232,577,1238,13817,59928,74784
Dental Hygienist,,6,Non-strikeable,7484,8355,9328,871,1844,19959,89808,111936
Disability Analyst 1,,6,Non-strikeable,5754,6423,7169,669,1415,15692,69048,86028
District Veterinarian,,6,Non-strikeable,7484,8355,9328,871,1844,19959,89808,111936
Dormitory Counselor 1,,6,Non-strikeable,4148,4619,5160,471,1012,11731,49776,61920
Dormitory Counselor 2,,6,Non-strikeable,4994,5571,6232,577,1238,13817,59928,74784
Economist 1,,6,Non-strikeable,5754,6423,7169,669,1415,15692,69048,86028
Electronic Publishing Design Specialist 1,,6,Non-strikeable,4337,4843,5408,506,1071,12197,52044,64896
Employment Adjudicator,,6,Non-strikeable,5754,6423,7169,669,1415,15692,69048,86028
Employment Appeals Board Legal Staff,,6,Non-strikeable,7484,8355,9328,871,1844,19959,89808,111936
Engineering Technician 2,,6,Non-strikeable,4766,5319,5936,553,1170,13255,57192,71232
Engineering Technician 3,,6,Non-strikeable,5231,5849,6529,618,1298,14402,62772,78348
Equipment Operator,,6,Non-strikeable,5231,5849,6529,618,1298,14402,62772,78348
Executive Support Specialist 1,,6,Non-strikeable,4337,4843,5408,506,1071,12197,52044,64896
Executive Support Specialist 2,,6,Non-strikeable,4994,5571,6232,577,1238,13817,59928,74784
Facility Energy Technician 4,,6,Non-strikeable,7484,8355,9328,871,1844,19959,89808,111936
Fiscal Analyst 1,,6,Non-strikeable,5754,6423,7169,669,1415,15692,69048,86028
Fiscal Auditor 1,,6,Non-strikeable,5754,6423,7169,669,1415,15692,69048,86028
Fish and Wildlife Technical Coordinator,,6,Non-strikeable,5231,5849,6529,618,1298,14402,62772,78348
Fish and Wildlife Technician,,6,Non-strikeable,4337,4843,5408,506,1071,12197,52044,64896
Fish and Wildlife Technician Entry,,6,Non-strikeable,3604,4026,4493,422,889,10389,43248,53916
Fish and Wildlife Technician Senior,,6,Non-strikeable,4766,5319,5936,553,1170,13255,57192,71232
Food Service Worker,,6,Non-strikeable,3604,4026,4493,422,889,10389,43248,53916
Forest Crew Coordinator,,6,Non-strikeable,4766,5319,5936,553,1170,13255,57192,71232
Forest Lookout,,6,Non-strikeable,3334,3703,4090,369,756,9723,40008,49080
Forest Management Technician,,6,Non-strikeable,4148,4619,5160,471,1012,11731,49776,61920
Forest Officer,,6,Non-strikeable,5754,6423,7169,669,1415,15692,69048,86028
Governmental Auditor 3,,6,Non-strikeable,7484,8355,9328,871,1844,19959,89808,111936
Grounds Maintenance Worker 1,,6,Non-strikeable,3780,4216,4707,436,927,10823,45360,56484
Grounds Maintenance Worker 2,,6,Non-strikeable,4337,4843,5408,506,1071,12197,52044,64896
Group Life Coordinator 1,,6,Non-strikeable,3959,4418,4921,459,962,11265,47508,59052
Group Life Coordinator 2,,6,Non-strikeable,4766,5319,5936,553,1170,13255,57192,71232
Human Services Assistant 2,,6,Non-strikeable,4148,4619,5160,471,1012,11731,49776,61920
Human Services Case Manager,,6,Non-strikeable,5231,5849,6529,618,1298,14402,62772,78348
Human Services Specialist 1,,6,Non-strikeable,3959,4418,4921,459,962,11265,47508,59052
Human Services Specialist 2,,6,Non-strikeable,4337,4843,5408,506,1071,12197,52044,64896
Human Services Specialist 3,,6,Non-strikeable,4766,5319,5936,553,1170,13255,57192,71232
Incident Response Operations Specialist,,6,Non-strikeable,4994,5571,6232,577,1238,13817,59928,74784
Industrial Hygienist 3,,6,Non-strikeable,7484,8355,9328,871,1844,19959,89808,111936
Information Systems Specialist 2,,6,Non-strikeable,5231,5849,6529,618,1298,14402,62772,78348
Information Systems Specialist 6,,6,Non-strikeable,7484,8355,9328,871,1844,19959,89808,111936
Information Systems Specialist 7,,6,Non-strikeable,7484,8355,9328,871,1844,19959,89808,111936
Investigator 1,,6,Non-strikeable,4766,5319,5936,553,1170,13255,57192,71232
Investigator 2,,6,Non-strikeable,5754,6423,7169,669,1415,15692,69048,86028
Laboratory Technician 2,,6,Non-strikeable,4337,4843,5408,506,1071,12197,52044,64896
Laborer/Student Worker,,6,Non-strikeable,3477,3838,4289,361,812,10076,41724,51468
Licensed Practical Nurse,,6,Non-strikeable,5222,5583,6213,361,991,14380,62664,74556
Livestock Brand Inspector,,6,Non-strikeable,3959,4418,4921,459,962,11265,47508,59052
Loan Specialist 1,,6,Non-strikeable,5754,6423,7169,669,1415,15692,69048,86028
Mail Delivery Driver,,6,Non-strikeable,3959,4418,4921,459,962,11265,47508,59052
Mail Equipment Operator 1,,6,Non-strikeable,3477,3838,4289,361,812,10076,41724,51468
Mail Equipment Operator 2,,6,Non-strikeable,3959,4418,4921,459,962,11265,47508,59052
Mail Services Assistant,,6,Non-strikeable,3604,4026,4493,422,889,10389,43248,53916
Manual Arts Instructor,,6,Non-strikeable,4337,4843,5408,506,1071,12197,52044,64896
Medical Laboratory Technician 2,,6,Non-strikeable,4994,5571,6232,577,1238,13817,59928,74784
Mental Health Security Technician,,6,Non-strikeable,4337,4843,5408,506,1071,12197,52044,64896
Mental Health Therapist 1,,6,Non-strikeable,4337,4843,5408,506,1071,12197,52044,64896
Mental Health Therapist 2,,6,Non-strikeable,4766,5319,5936,553,1170,13255,57192,71232
Mental Health Therapy Coordinator,,6,Non-strikeable,4766,5319,5936,553,1170,13255,57192,71232
Mental Health Therapy Technician,,6,Non-strikeable,3959,4418,4921,459,962,11265,47508,59052
Microbiologist 1,,6,Non-strikeable,5754,6423,7169,669,1415,15692,69048,86028
Motor Carrier Enforcement Officer 1,,6,Non-strikeable,5231,5849,6529,618,1298,14402,62772,78348
Natural Resource Specialist 1,,6,Non-strikeable,5231,5849,6529,618,1298,14402,62772,78348
Nutrition Consultant,,6,Non-strikeable,7484,8355,9328,871,1844,19959,89808,111936
Occupational Safety Specialist 3,,6,Non-strikeable,7484,8355,9328,871,1844,19959,89808,111936
Office Coordinator,,6,Non-strikeable,3959,4418,4921,459,962,11265,47508,59052
Office Specialist 1,,6,Non-strikeable,3604,4026,4493,422,889,10389,43248,53916
Office Specialist 2,,6,Non-strikeable,3959,4418,4921,459,962,11265,47508,59052
Operations & Policy Analyst 1,,6,Non-strikeable,5754,6423,7169,669,1415,15692,69048,86028
Park Ranger 2,,6,Non-strikeable,4994,5571,6232,577,1238,13817,59928,74784
Park Ranger Assistant,,6,Non-strikeable,3477,3838,4289,361,812,10076,41724,51468
Park Specialist,,6,Non-strikeable,4337,4843,5408,506,1071,12197,52044,64896
Parking Services Representative,,6,Non-strikeable,3780,4216,4707,436,927,10823,45360,56484
Parts Specialist 2,,6,Non-strikeable,4994,5571,6232,577,1238,13817,59928,74784
Payroll Analyst,,6,Non-strikeable,5231,5849,6529,618,1298,14402,62772,78348
Pharmacist Resident,,6,Non-strikeable,5754,6423,7169,669,1415,15692,69048,86028
Pharmacy Clerk & Technician 2,,6,Non-strikeable,4148,4619,5160,471,1012,11731,49776,61920
Pharmacy Clerk & Technician 3,,6,Non-strikeable,4337,4843,5408,506,1071,12197,52044,64896
Physical/Electronic Security Technician,,6,Non-strikeable,4994,5571,6232,577,1238,13817,59928,74784
Print Services Technician,,6,Non-strikeable,4148,4619,5160,471,1012,11731,49776,61920
Printing Production Coordinator,,6,Non-strikeable,5754,6423,7169,669,1415,15692,69048,86028
Procurement & Contract Specialist 1,,6,Non-strikeable,5754,6423,7169,669,1415,15692,69048,86028
Procurement & Contract Specialist 3,,6,Non-strikeable,7484,8355,9328,871,1844,19959,89808,111936
Procurement And Contract Assistant,,6,Non-strikeable,4766,5319,5936,553,1170,13255,57192,71232
Program Analyst 1,,6,Non-strikeable,5754,6423,7169,669,1415,15692,69048,86028
Program Analyst 3,,6,Non-strikeable,7484,8355,9328,871,1844,19959,89808,111936
Psychiatric Social Worker,,6,Non-strikeable,7484,8355,9328,871,1844,19959,89808,111936
Public Affairs Specialist 2,,6,Non-strikeable,7484,8355,9328,871,1844,19959,89808,111936
Public Health Toxicologist 1,,6,Non-strikeable,7484,8355,9328,871,1844,19959,89808,111936
Public Service Representative 2,,6,Non-strikeable,3604,4026,4493,422,889,10389,43248,53916
Public Service Representative 3,,6,Non-strikeable,3959,4418,4921,459,962,11265,47508,59052
Public Service Representative 4,,6,Non-strikeable,4994,5571,6232,577,1238,13817,59928,74784
Rehabilitation Instructor For The Blind,,6,Non-strikeable,5754,6423,7169,669,1415,15692,69048,86028
Rehabilitation Instructor For The Blind (Entry),,6,Non-strikeable,5231,5849,6529,618,1298,14402,62772,78348
Research Analyst 1,,6,Non-strikeable,4766,5319,5936,553,1170,13255,57192,71232
Research Analyst 2,,6,Non-strikeable,5754,6423,7169,669,1415,15692,69048,86028
Retirement Counselor 1,,6,Non-strikeable,4994,5571,6232,577,1238,13817,59928,74784
Revenue Agent 1,,6,Non-strikeable,4337,4843,5408,506,1071,12197,52044,64896
Revenue Agent 2,,6,Non-strikeable,4766,5319,5936,553,1170,13255,57192,71232
Revenue Agent 3,,6,Non-strikeable,5231,5849,6529,618,1298,14402,62772,78348
Safety Specialist 1,,6,Non-strikeable,5754,6423,7169,669,1415,15692,69048,86028
Scientific Instrument Technician,,6,Non-strikeable,5231,5849,6529,618,1298,14402,62772,78348
Seamster,,6,Non-strikeable,3959,4418,4921,459,962,11265,47508,59052
Shipping Point Inspector 1,,6,Non-strikeable,3959,4418,4921,459,962,11265,47508,59052
Shipping Point Inspector 2,,6,Non-strikeable,4337,4843,5408,506,1071,12197,52044,64896
Sign Technician 1,,6,Non-strikeable,4766,5319,5936,553,1170,13255,57192,71232
Social Service Assistant,,6,Non-strikeable,4337,4843,5408,506,1071,12197,52044,64896
State Library Specialist 1,,6,Non-strikeable,3477,3838,4289,361,812,10076,41724,51468
Supply Specialist 1,,6,Non-strikeable,3780,4216,4707,436,927,10823,45360,56484
Supply Specialist 2,,6,Non-strikeable,4994,5571,6232,577,1238,13817,59928,74784
Tax Auditor/Entry,,6,Non-strikeable,4994,5571,6232,577,1238,13817,59928,74784
Teaching Assistant,,6,Non-strikeable,3959,4418,4921,459,962,11265,47508,59052
Training & Development Specialist 1,,6,Non-strikeable,5754,6423,7169,669,1415,15692,69048,86028
Transportation Maintenance Coordinator 1,,6,Non-strikeable,5231,5849,6529,618,1298,14402,62772,78348
Transportation Maintenance Specialist 1,,6,Non-strikeable,4337,4843,5408,506,1071,12197,52044,64896
Transportation Maintenance Specialist 2,,6,Non-strikeable,4766,5319,5936,553,1170,13255,57192,71232
Transportation Services Office Leader,,6,Non-strikeable,5231,5849,6529,618,1298,14402,62772,78348
Transportation Services Representative 1,,6,Non-strikeable,4337,4843,5408,506,1071,12197,52044,64896
Transportation Services Representative 2,,6,Non-strikeable,4766,5319,5936,553,1170,13255,57192,71232
Transportation Telecommunications Specialist 1,,6,Non-strikeable,4994,5571,6232,577,1238,13817,59928,74784
Transporting Mental Health Aide,,6,Non-strikeable,4337,4843,5408,506,1071,12197,52044,64896
Truck Driver 1,,6,Non-strikeable,4337,4843,5408,506,1071,12197,52044,64896
Truck Driver 2,,6,Non-strikeable,4994,5571,6232,577,1238,13817,59928,74784
Veterans Service Officer,,6,Non-strikeable,5754,6423,7169,669,1415,15692,69048,86028
Veterans Trust Officer,,6,Non-strikeable,5754,6423,7169,669,1415,15692,69048,86028
Vocational Rehabilitation Counselor Entry,,6,Non-strikeable,4994,5571,6232,577,1238,13817,59928,74784
Water Resource Data Technician 1,,6,Non-strikeable,4766,5319,5936,553,1170,13255,57192,71232
Water Resource Data Technician 2,,6,Non-strikeable,5231,5849,6529,618,1298,14402,62772,78348
Wildland Fire Dispatcher,,6,Non-strikeable,3959,4418,4921,459,962,11265,47508,59052
Wildland Fire Dispatcher Entry,,6,Non-strikeable,3334,3703,4090,369,756,9723,40008,49080
Wildland Fire Suppression Specialist,,6,Non-strikeable,4337,4843,5408,506,1071,12197,52044,64896
Wildland Fire Suppression Specialist Entry,,6,Non-strikeable,3604,4026,4493,422,889,10389,43248,53916
Word Processing Technician 2,,6,Non-strikeable,3780,4216,4707,436,927,10823,45360,56484
Word Processing Technician 3,,6,Non-strikeable,4148,4619,5160,471,1012,11731,49776,61920
Youth Corrections Unit Coordinator,,6,Non-strikeable,5754,6423,7169,669,1415,15692,69048,86028
Accountant 1,,7,Non-strikeable,6031,6423,6844,392,813,16375,72372,82128
Accounting Technician,,7,Non-strikeable,4994,5571,6232,577,1238,13817,59928,74784
Activities Coordinator,,7,Non-strikeable,4994,5571,6232,577,1238,13817,59928,74784
Administrative Specialist 1,,7,Non-strikeable,4547,5076,5667,529,1120,12715,54564,68004
Administrative Specialist 2,,7,Non-strikeable,5231,5849,6529,618,1298,14402,62772,78348
Apprenticeship Representative,,7,Non-strikeable,6031,6729,7518,698,1487,16375,72372,90216
Automotive Fleet Attendant,,7,Non-strikeable,3959,4418,4921,459,962,11265,47508,59052
Automotive Technician 1,,7,Non-strikeable,4994,5571,6232,577,1238,13817,59928,74784
Automotive Technician 2,,7,Non-strikeable,6031,6729,7518,698,1487,16375,72372,90216
Behavioral Health Specialist 3,,7,Non-strikeable,7845,8754,9775,909,1930,20849,94140,117300
Biological Science Assistant,,7,Non-strikeable,3604,4026,4493,422,889,10389,43248,53916
Business & Employment Specialist 2,,7,Non-strikeable,5492,6128,6844,636,1352,15046,65904,82128
Certified Occupation Therapist Assistant,,7,Non-strikeable,5231,5849,6529,618,1298,14402,62772,78348
Chemist 3,,7,Non-strikeable,7845,8754,9775,909,1930,20849,94140,117300
Child Support Case Manager,,7,Non-strikeable,5492,6128,6844,636,1352,15046,65904,82128
Child Support Case Manager Entry,,7,Non-strikeable,4994,5571,6232,577,1238,13817,59928,74784
Child Support Specialist,,7,Non-strikeable,6031,6729,7518,698,1487,16375,72372,90216
Civil Rights Investigator 1,,7,Non-strikeable,5492,6128,6844,636,1352,15046,65904,82128
Compliance Specialist 1,,7,Non-strikeable,5492,6128,6844,636,1352,15046,65904,82128
Compliance Specialist 3,,7,Non-strikeable,7845,8754,9775,909,1930,20849,94140,117300
Cook,,7,Non-strikeable,4547,5076,5667,529,1120,12715,54564,68004
Custodial Services Coordinator,,7,Non-strikeable,3780,4216,4707,436,927,10823,45360,56484
Data Entry Control Technician,,7,Non-strikeable,3604,4026,4493,422,889,10389,43248,53916
Data Entry Operator,,7,Non-strikeable,3604,4026,4493,422,889,10389,43248,53916
Dental Assistant 2,,7,Non-strikeable,5231,5849,6529,618,1298,14402,62772,78348
Dental Hygienist,,7,Non-strikeable,7845,8754,9775,909,1930,20849,94140,117300
Disability Analyst 1,,7,Non-strikeable,6031,6729,7518,698,1487,16375,72372,90216
District Veterinarian,,7,Non-strikeable,7845,8754,9775,909,1930,20849,94140,117300
Dormitory Counselor 1,,7,Non-strikeable,4337,4843,5408,506,1071,12197,52044,64896
Dormitory Counselor 2,,7,Non-strikeable,5231,5849,6529,618,1298,14402,62772,78348
Economist 1,,7,Non-strikeable,6031,6729,7518,698,1487,16375,72372,90216
Electronic Publishing Design Specialist 1,,7,Non-strikeable,4547,5076,5667,529,1120,12715,54564,68004
Employment Adjudicator,,7,Non-strikeable,6031,6729,7518,698,1487,16375,72372,90216
Employment Appeals Board Legal Staff,,7,Non-strikeable,7845,8754,9775,909,1930,20849,94140,117300
Engineering Technician 2,,7,Non-strikeable,4994,5571,6232,577,1238,13817,59928,74784
Engineering Technician 3,,7,Non-strikeable,5492,6128,6844,636,1352,15046,65904,82128
Equipment Operator,,7,Non-strikeable,5492,6128,6844,636,1352,15046,65904,82128
Executive Support Specialist 1,,7,Non-strikeable,4547,5076,5667,529,1120,12715,54564,68004
Executive Support Specialist 2,,7,Non-strikeable,5231,5849,6529,618,1298,14402,62772,78348
Facility Energy Technician 4,,7,Non-strikeable,7845,8754,9775,909,1930,20849,94140,117300
Fiscal Analyst 1,,7,Non-strikeable,6031,6729,7518,698,1487,16375,72372,90216
Fiscal Auditor 1,,7,Non-strikeable,6031,6729,7518,698,1487,16375,72372,90216
Fish and Wildlife Technical Coordinator,,7,Non-strikeable,5492,6128,6844,636,1352,15046,65904,82128
Fish and Wildlife Technician,,7,Non-strikeable,4547,5076,5667,529,1120,12715,54564,68004
Fish and Wildlife Technician Entry,,7,Non-strikeable,3780,4216,4707,436,927,10823,45360,56484
Fish and Wildlife Technician Senior,,7,Non-strikeable,4994,5571,6232,577,1238,13817,59928,74784
Food Service Worker,,7,Non-strikeable,3780,4216,4707,436,927,10823,45360,56484
Forest Crew Coordinator,,7,Non-strikeable,4994,5571,6232,577,1238,13817,59928,74784
Forest Lookout,,7,Non-strikeable,3477,3838,4289,361,812,10076,41724,51468
Forest Management Technician,,7,Non-strikeable,4337,4843,5408,506,1071,12197,52044,64896
Forest Officer,,7,Non-strikeable,6031,6729,7518,698,1487,16375,72372,90216
Governmental Auditor 3,,7,Non-strikeable,7845,8754,9775,909,1930,20849,94140,117300
Grounds Maintenance Worker 1,,7,Non-strikeable,3959,4418,4921,459,962,11265,47508,59052
Grounds Maintenance Worker 2,,7,Non-strikeable,4547,5076,5667,529,1120,12715,54564,68004
Group Life Coordinator 1,,7,Non-strikeable,4148,4619,5160,471,1012,11731,49776,61920
Group Life Coordinator 2,,7,Non-strikeable,4994,5571,6232,577,1238,13817,59928,74784
Human Services Assistant 2,,7,Non-strikeable,4337,4843,5408,506,1071,12197,52044,64896
Human Services Case Manager,,7,Non-strikeable,5492,6128,6844,636,1352,15046,65904,82128
Human Services Specialist 1,,7,Non-strikeable,4148,4619,5160,471,1012,11731,49776,61920
Human Services Specialist 2,,7,Non-strikeable,4547,5076,5667,529,1120,12715,54564,68004
Human Services Specialist 3,,7,Non-strikeable,4994,5571,6232,577,1238,13817,59928,74784
Incident Response Operations Specialist,,7,Non-strikeable,5231,5849,6529,618,1298,14402,62772,78348
Industrial Hygienist 3,,7,Non-strikeable,7845,8754,9775,909,1930,20849,94140,117300
Information Systems Specialist 2,,7,Non-strikeable,5492,6128,6844,636,1352,15046,65904,82128
Information Systems Specialist 6,,7,Non-strikeable,7845,8754,9775,909,1930,20849,94140,117300
Information Systems Specialist 7,,7,Non-strikeable,7845,8754,9775,909,1930,20849,94140,117300
Investigator 1,,7,Non-strikeable,4994,5571,6232,577,1238,13817,59928,74784
Investigator 2,,7,Non-strikeable,6031,6729,7518,698,1487,16375,72372,90216
Laboratory Technician 2,,7,Non-strikeable,4547,5076,5667,529,1120,12715,54564,68004
Laborer/Student Worker,,7,Non-strikeable,3604,4026,4493,422,889,10389,43248,53916
Licensed Practical Nurse,,7,Non-strikeable,5242,5831,6486,589,1244,14429,62904,77832
Livestock Brand Inspector,,7,Non-strikeable,4148,4619,5160,471,1012,11731,49776,61920
Loan Specialist 1,,7,Non-strikeable,6031,6729,7518,698,1487,16375,72372,90216
Mail Delivery Driver,,7,Non-strikeable,4148,4619,5160,471,1012,11731,49776,61920
Mail Equipment Operator 1,,7,Non-strikeable,3604,4026,4493,422,889,10389,43248,53916
Mail Equipment Operator 2,,7,Non-strikeable,4148,4619,5160,471,1012,11731,49776,61920
Mail Services Assistant,,7,Non-strikeable,3780,4216,4707,436,927,10823,45360,56484
Manual Arts Instructor,,7,Non-strikeable,4547,5076,5667,529,1120,12715,54564,68004
Medical Laboratory Technician 2,,7,Non-strikeable,5231,5849,6529,618,1298,14402,62772,78348
Mental Health Security Technician,,7,Non-strikeable,4547,5076,5667,529,1120,12715,54564,68004
Mental Health Therapist 1,,7,Non-strikeable,4547,5076,5667,529,1120,12715,54564,68004
Mental Health Therapist 2,,7,Non-strikeable,4994,5571,6232,577,1238,13817,59928,74784
Mental Health Therapy Coordinator,,7,Non-strikeable,4994,5571,6232,577,1238,13817,59928,74784
Mental Health Therapy Technician,,7,Non-strikeable,4148,4619,5160,471,1012,11731,49776,61920
Microbiologist 1,,7,Non-strikeable,6031,6729,7518,698,1487,16375,72372,90216
Motor Carrier Enforcement Officer 1,,7,Non-strikeable,5492,6128,6844,636,1352,15046,65904,82128
Natural Resource Specialist 1,,7,Non-strikeable,5492,6128,6844,636,1352,15046,65904,82128
Nutrition Consultant,,7,Non-strikeable,7845,8754,9775,909,1930,20849,94140,117300
Occupational Safety Specialist 3,,7,Non-strikeable,7845,8754,9775,909,1930,20849,94140,117300
Office Coordinator,,7,Non-strikeable,4148,4619,5160,471,1012,11731,49776,61920
Office Specialist 1,,7,Non-strikeable,3780,4216,4707,436,927,10823,45360,56484
Office Specialist 2,,7,Non-strikeable,4148,4619,5160,471,1012,11731,49776,61920
Operations & Policy Analyst 1,,7,Non-strikeable,6031,6729,7518,698,1487,16375,72372,90216
Park Ranger 2,,7,Non-strikeable,5231,5849,6529,618,1298,14402,62772,78348
Park Ranger Assistant,,7,Non-strikeable,3604,4026,4493,422,889,10389,43248,53916
Park Specialist,,7,Non-strikeable,4547,5076,5667,529,1120,12715,54564,68004
Parking Services Representative,,7,Non-strikeable,3959,4418,4921,459,962,11265,47508,59052
Parts Specialist 2,,7,Non-strikeable,5231,5849,6529,618,1298,14402,62772,78348
Payroll Analyst,,7,Non-strikeable,5492,6128,6844,636,1352,15046,65904,82128
Pharmacist Resident,,7,Non-strikeable,6031,6729,7518,698,1487,16375,72372,90216
Pharmacy Clerk & Technician 2,,7,Non-strikeable,4337,4843,5408,506,1071,12197,52044,64896
Pharmacy Clerk & Technician 3,,7,Non-strikeable,4547,5076,5667,529,1120,12715,54564,68004
Physical/Electronic Security Technician,,7,Non-strikeable,5231,5849,6529,618,1298,14402,62772,78348
Print Services Technician,,7,Non-strikeable,4337,4843,5408,506,1071,12197,52044,64896
Printing Production Coordinator,,7,Non-strikeable,6031,6729,7518,698,1487,16375,72372,90216
Procurement & Contract Specialist 1,,7,Non-strikeable,6031,6729,7518,698,1487,16375,72372,90216
Procurement & Contract Specialist 3,,7,Non-strikeable,7845,8754,9775,909,1930,20849,94140,117300
Procurement And Contract Assistant,,7,Non-strikeable,4994,5571,6232,577,1238,13817,59928,74784
Program Analyst 1,,7,Non-strikeable,6031,6729,7518,698,1487,16375,72372,90216
Program Analyst 3,,7,Non-strikeable,7845,8754,9775,909,1930,20849,94140,117300
Psychiatric Social Worker,,7,Non-strikeable,7845,8754,9775,909,1930,20849,94140,117300
Public Affairs Specialist 2,,7,Non-strikeable,7845,8754,9775,909,1930,20849,94140,117300
Public Health Toxicologist 1,,7,Non-strikeable,7845,8754,9775,909,1930,20849,94140,117300
Public Service Representative 2,,7,Non-strikeable,3780,4216,4707,436,927,10823,45360,56484
Public Service Representative 3,,7,Non-strikeable,4148,4619,5160,471,1012,11731,49776,61920
Public Service Representative 4,,7,Non-strikeable,5231,5849,6529,618,1298,14402,62772,78348
Rehabilitation Instructor For The Blind,,7,Non-strikeable,6031,6729,7518,698,1487,16375,72372,90216
Rehabilitation Instructor For The Blind (Entry),,7,Non-strikeable,5492,6128,6844,636,1352,15046,65904,82128
Research Analyst 1,,7,Non-strikeable,4994,5571,6232,577,1238,13817,59928,74784
Research Analyst 2,,7,Non-strikeable,6031,6729,7518,698,1487,16375,72372,90216
Retirement Counselor 1,,7,Non-strikeable,5231,5849,6529,618,1298,14402,62772,78348
Revenue Agent 1,,7,Non-strikeable,4547,5076,5667,529,1120,12715,54564,68004
Revenue Agent 2,,7,Non-strikeable,4994,5571,6232,577,1238,13817,59928,74784
Revenue Agent 3,,7,Non-strikeable,5492,6128,6844,636,1352,15046,65904,82128
Safety Specialist 1,,7,Non-strikeable,6031,6729,7518,698,1487,16375,72372,90216
Scientific Instrument Technician,,7,Non-strikeable,5492,6128,6844,636,1352,15046,65904,82128
Seamster,,7,Non-strikeable,4148,4619,5160,471,1012,11731,49776,61920
Shipping Point Inspector 1,,7,Non-strikeable,4148,4619,5160,471,1012,11731,49776,61920
Shipping Point Inspector 2,,7,Non-strikeable,4547,5076,5667,529,1120,12715,54564,68004
Sign Technician 1,,7,Non-strikeable,4994,5571,6232,577,1238,13817,59928,74784
Social Service Assistant,,7,Non-strikeable,4547,5076,5667,529,1120,12715,54564,68004
State Library Specialist 1,,7,Non-strikeable,3604,4026,4493,422,889,10389,43248,53916
Supply Specialist 1,,7,Non-strikeable,3959,4418,4921,459,962,11265,47508,59052
Supply Specialist 2,,7,Non-strikeable,5231,5849,6529,618,1298,14402,62772,78348
Tax Auditor/Entry,,7,Non-strikeable,5231,5849,6529,618,1298,14402,62772,78348
Teaching Assistant,,7,Non-strikeable,4148,4619,5160,471,1012,11731,49776,61920
Training & Development Specialist 1,,7,Non-strikeable,6031,6729,7518,698,1487,16375,72372,90216
Transportation Maintenance Coordinator 1,,7,Non-strikeable,5492,6128,6844,636,1352,15046,65904,82128
Transportation Maintenance Specialist 1,,7,Non-strikeable,4547,5076,5667,529,1120,12715,54564,68004
Transportation Maintenance Specialist 2,,7,Non-strikeable,4994,5571,6232,577,1238,13817,59928,74784
Transportation Services Office Leader,,7,Non-strikeable,5492,6128,6844,636,1352,15046,65904,82128
Transportation Services Representative 1,,7,Non-strikeable,4547,5076,5667,529,1120,12715,54564,68004
Transportation Services Representative 2,,7,Non-strikeable,4994,5571,6232,577,1238,13817,59928,74784
Transportation Telecommunications Specialist 1,,7,Non-strikeable,5231,5849,6529,618,1298,14402,62772,78348
Transporting Mental Health Aide,,7,Non-strikeable,4547,5076,5667,529,1120,12715,54564,68004
Truck Driver 1,,7,Non-strikeable,4547,5076,5667,529,1120,12715,54564,68004
Truck Driver 2,,7,Non-strikeable,5231,5849,6529,618,1298,14402,62772,78348
Veterans Service Officer,,7,Non-strikeable,6031,6729,7518,698,1487,16375,72372,90216
Veterans Trust Officer,,7,Non-strikeable,6031,6729,7518,698,1487,16375,72372,90216
Vocational Rehabilitation Counselor Entry,,7,Non-strikeable,5231,5849,6529,618,1298,14402,62772,78348
Water Resource Data Technician 1,,7,Non-strikeable,4994,5571,6232,577,1238,13817,59928,74784
Water Resource Data Technician 2,,7,Non-strikeable,5492,6128,6844,636,1352,15046,65904,82128
Wildland Fire Dispatcher,,7,Non-strikeable,4148,4619,5160,471,1012,11731,49776,61920
Wildland Fire Dispatcher Entry,,7,Non-strikeable,3477,3838,4289,361,812,10076,41724,51468
Wildland Fire Suppression Specialist,,7,Non-strikeable,4547,5076,5667,529,1120,12715,54564,68004
Wildland Fire Suppression Specialist Entry,,7,Non-strikeable,3780,4216,4707,436,927,10823,45360,56484
Word Processing Technician 2,,7,Non-strikeable,3959,4418,4921,459,962,11265,47508,59052
Word Processing Technician 3,,7,Non-strikeable,4337,4843,5408,506,1071,12197,52044,64896
Youth Corrections Unit Coordinator,,7,Non-strikeable,6031,6729,7518,698,1487,16375,72372,90216
Accountant 1,,8,Non-strikeable,6318,6729,7169,411,851,17083,75816,86028
Accounting Technician,,8,Non-strikeable,5231,5849,6529,618,1298,14402,62772,78348
Activities Coordinator,,8,Non-strikeable,5231,5849,6529,618,1298,14402,62772,78348
Administrative Specialist 1,,8,Non-strikeable,4766,5319,5936,553,1170,13255,57192,71232
Administrative Specialist 2,,8,Non-strikeable,5492,6128,6844,636,1352,15046,65904,82128
Apprenticeship Representative,,8,Non-strikeable,6318,7056,7876,738,1558,17083,75816,94512
Automotive Fleet Attendant,,8,Non-strikeable,4148,4619,5160,471,1012,11731,49776,61920
Automotive Technician 1,,8,Non-strikeable,5231,5849,6529,618,1298,14402,62772,78348
Automotive Technician 2,,8,Non-strikeable,6318,7056,7876,738,1558,17083,75816,94512
Behavioral Health Specialist 3,,8,Non-strikeable,8220,9174,10243,954,2023,21774,98640,122916
Biological Science Assistant,,8,Non-strikeable,3780,4216,4707,436,927,10823,45360,56484
Business & Employment Specialist 2,,8,Non-strikeable,5754,6423,7169,669,1415,15692,69048,86028
Certified Occupation Therapist Assistant,,8,Non-strikeable,5492,6128,6844,636,1352,15046,65904,82128
Chemist 3,,8,Non-strikeable,8220,9174,10243,954,2023,21774,98640,122916
Child Support Case Manager,,8,Non-strikeable,5754,6423,7169,669,1415,15692,69048,86028
Child Support Case Manager Entry,,8,Non-strikeable,5231,5849,6529,618,1298,14402,62772,78348
Child Support Specialist,,8,Non-strikeable,6318,7056,7876,738,1558,17083,75816,94512
Civil Rights Investigator 1,,8,Non-strikeable,5754,6423,7169,669,1415,15692,69048,86028
Compliance Specialist 1,,8,Non-strikeable,5754,6423,7169,669,1415,15692,69048,86028
Compliance Specialist 3,,8,Non-strikeable,8220,9174,10243,954,2023,21774,98640,122916
Cook,,8,Non-strikeable,4766,5319,5936,553,1170,13255,57192,71232
Custodial Services Coordinator,,8,Non-strikeable,3959,4418,4921,459,962,11265,47508,59052
Data Entry Control Technician,,8,Non-strikeable,3780,4216,4707,436,927,10823,45360,56484
Data Entry Operator,,8,Non-strikeable,3780,4216,4707,436,927,10823,45360,56484
Dental Assistant 2,,8,Non-strikeable,5492,6128,6844,636,1352,15046,65904,82128
Dental Hygienist,,8,Non-strikeable,8220,9174,10243,954,2023,21774,98640,122916
Disability Analyst 1,,8,Non-strikeable,6318,7056,7876,738,1558,17083,75816,94512
District Veterinarian,,8,Non-strikeable,8220,9174,10243,954,2023,21774,98640,122916
Dormitory Counselor 1,,8,Non-strikeable,4547,5076,5667,529,1120,12715,54564,68004
Dormitory Counselor 2,,8,Non-strikeable,5492,6128,6844,636,1352,15046,65904,82128
Economist 1,,8,Non-strikeable,6318,7056,7876,738,1558,17083,75816,94512
Electronic Publishing Design Specialist 1,,8,Non-strikeable,4766,5319,5936,553,1170,13255,57192,71232
Employment Adjudicator,,8,Non-strikeable,6318,7056,7876,738,1558,17083,75816,94512
Employment Appeals Board Legal Staff,,8,Non-strikeable,8220,9174,10243,954,2023,21774,98640,122916
Engineering Technician 2,,8,Non-strikeable,5231,5849,6529,618,1298,14402,62772,78348
Engineering Technician 3,,8,Non-strikeable,5754,6423,7169,669,1415,15692,69048,86028
Equipment Operator,,8,Non-strikeable,5754,6423,7169,669,1415,15692,69048,86028
Executive Support Specialist 1,,8,Non-strikeable,4766,5319,5936,553,1170,13255,57192,71232
Executive Support Specialist 2,,8,Non-strikeable,5492,6128,6844,636,1352,15046,65904,82128
Facility Energy Technician 4,,8,Non-strikeable,8220,9174,10243,954,2023,21774,98640,122916
Fiscal Analyst 1,,8,Non-strikeable,6318,7056,7876,738,1558,17083,75816,94512
Fiscal Auditor 1,,8,Non-strikeable,6318,7056,7876,738,1558,17083,75816,94512
Fish and Wildlife Technical Coordinator,,8,Non-strikeable,5754,6423,7169,669,1415,15692,69048,86028
Fish and Wildlife Technician,,8,Non-strikeable,4766,5319,5936,553,1170,13255,57192,71232
Fish and Wildlife Technician Entry,,8,Non-strikeable,3959,4418,4921,459,962,11265,47508,59052
Fish and Wildlife Technician Senior,,8,Non-strikeable,5231,5849,6529,618,1298,14402,62772,78348
Food Service Worker,,8,Non-strikeable,3959,4418,4921,459,962,11265,47508,59052
Forest Crew Coordinator,,8,Non-strikeable,5231,5849,6529,618,1298,14402,62772,78348
Forest Lookout,,8,Non-strikeable,3604,4026,4493,422,889,10389,43248,53916
Forest Management Technician,,8,Non-strikeable,4547,5076,5667,529,1120,12715,54564,68004
Forest Officer,,8,Non-strikeable,6318,7056,7876,738,1558,17083,75816,94512
Governmental Auditor 3,,8,Non-strikeable,8220,9174,10243,954,2023,21774,98640,122916
Grounds Maintenance Worker 1,,8,Non-strikeable,4148,4619,5160,471,1012,11731,49776,61920
Grounds Maintenance Worker 2,,8,Non-strikeable,4766,5319,5936,553,1170,13255,57192,71232
Group Life Coordinator 1,,8,Non-strikeable,4337,4843,5408,506,1071,12197,52044,64896
Group Life Coordinator 2,,8,Non-strikeable,5231,5849,6529,618,1298,14402,62772,78348
Human Services Assistant 2,,8,Non-strikeable,4547,5076,5667,529,1120,12715,54564,68004
Human Services Case Manager,,8,Non-strikeable,5754,6423,7169,669,1415,15692,69048,86028
Human Services Specialist 1,,8,Non-strikeable,4337,4843,5408,506,1071,12197,52044,64896
Human Services Specialist 2,,8,Non-strikeable,4766,5319,5936,553,1170,13255,57192,71232
Human Services Specialist 3,,8,Non-strikeable,5231,5849,6529,618,1298,14402,62772,78348
Incident Response Operations Specialist,,8,Non-strikeable,5492,6128,6844,636,1352,15046,65904,82128
Industrial Hygienist 3,,8,Non-strikeable,8220,9174,10243,954,2023,21774,98640,122916
Information Systems Specialist 2,,8,Non-strikeable,5754,6423,7169,669,1415,15692,69048,86028
Information Systems Specialist 6,,8,Non-strikeable,8220,9174,10243,954,2023,21774,98640,122916
Information Systems Specialist 7,,8,Non-strikeable,8220,9174,10243,954,2023,21774,98640,122916
Investigator 1,,8,Non-strikeable,5231,5849,6529,618,1298,14402,62772,78348
Investigator 2,,8,Non-strikeable,6318,7056,7876,738,1558,17083,75816,94512
Laboratory Technician 2,,8,Non-strikeable,4766,5319,5936,553,1170,13255,57192,71232
Laborer/Student Worker,,8,Non-strikeable,3780,4216,4707,436,927,10823,45360,56484
Licensed Practical Nurse,,8,Non-strikeable,5475,6088,6771,613,1296,15004,65700,81252
Livestock Brand Inspector,,8,Non-strikeable,4337,4843,5408,506,1071,12197,52044,64896
Loan Specialist 1,,8,Non-strikeable,6318,7056,7876,738,1558,17083,75816,94512
Mail Delivery Driver,,8,Non-strikeable,4337,4843,5408,506,1071,12197,52044,64896
Mail Equipment Operator 1,,8,Non-strikeable,3780,4216,4707,436,927,10823,45360,56484
Mail Equipment Operator 2,,8,Non-strikeable,4337,4843,5408,506,1071,12197,52044,64896
Mail Services Assistant,,8,Non-strikeable,3959,4418,4921,459,962,11265,47508,59052
Manual Arts Instructor,,8,Non-strikeable,4766,5319,5936,553,1170,13255,57192,71232
Medical Laboratory Technician 2,,8,Non-strikeable,5492,6128,6844,636,1352,15046,65904,82128
Mental Health Security Technician,,8,Non-strikeable,4766,5319,5936,553,1170,13255,57192,71232
Mental Health Therapist 1,,8,Non-strikeable,4766,5319,5936,553,1170,13255,57192,71232
Mental Health Therapist 2,,8,Non-strikeable,5231,5849,6529,618,1298,14402,62772,78348
Mental Health Therapy Coordinator,,8,Non-strikeable,5231,5849,6529,618,1298,14402,62772,78348
Mental Health Therapy Technician,,8,Non-strikeable,4337,4843,5408,506,1071,12197,52044,64896
Microbiologist 1,,8,Non-strikeable,6318,7056,7876,738,1558,17083,75816,94512
Motor Carrier Enforcement Officer 1,,8,Non-strikeable,5754,6423,7169,669,1415,15692,69048,86028
Natural Resource Specialist 1,,8,Non-strikeable,5754,6423,7169,669,1415,15692,69048,86028
Nutrition Consultant,,8,Non-strikeable,8220,9174,10243,954,2023,21774,98640,122916
Occupational Safety Specialist 3,,8,Non-strikeable,8220,9174,10243,954,2023,21774,98640,122916
Office Coordinator,,8,Non-strikeable,4337,4843,5408,506,1071,12197,52044,64896
Office Specialist 1,,8,Non-strikeable,3959,4418,4921,459,962,11265,47508,59052
Office Specialist 2,,8,Non-strikeable,4337,4843,5408,506,1071,12197,52044,64896
Operations & Policy Analyst 1,,8,Non-strikeable,6318,7056,7876,738,1558,17083,75816,94512
Park Ranger 2,,8,Non-strikeable,5492,6128,6844,636,1352,15046,65904,82128
Park Ranger Assistant,,8,Non-strikeable,3780,4216,4707,436,927,10823,45360,56484
Park Specialist,,8,Non-strikeable,4766,5319,5936,553,1170,13255,57192,71232
Parking Services Representative,,8,Non-strikeable,4148,4619,5160,471,1012,11731,49776,61920
Parts Specialist 2,,8,Non-strikeable,5492,6128,6844,636,1352,15046,65904,82128
Payroll Analyst,,8,Non-strikeable,5754,6423,7169,669,1415,15692,69048,86028
Pharmacist Resident,,8,Non-strikeable,6318,7056,7876,738,1558,17083,75816,94512
Pharmacy Clerk & Technician 2,,8,Non-strikeable,4547,5076,5667,529,1120,12715,54564,68004
Pharmacy Clerk & Technician 3,,8,Non-strikeable,4766,5319,5936,553,1170,13255,57192,71232
Physical/Electronic Security Technician,,8,Non-strikeable,5492,6128,6844,636,1352,15046,65904,82128
Print Services Technician,,8,Non-strikeable,4547,5076,5667,529,1120,12715,54564,68004
Printing Production Coordinator,,8,Non-strikeable,6318,7056,7876,738,1558,17083,75816,94512
Procurement & Contract Specialist 1,,8,Non-strikeable,6318,7056,7876,738,1558,17083,75816,94512
Procurement & Contract Specialist 3,,8,Non-strikeable,8220,9174,10243,954,2023,21774,98640,122916
Procurement And Contract Assistant,,8,Non-strikeable,5231,5849,6529,618,1298,14402,62772,78348
Program Analyst 1,,8,Non-strikeable,6318,7056,7876,738,1558,17083,75816,94512
Program Analyst 3,,8,Non-strikeable,8220,9174,10243,954,2023,21774,98640,122916
Psychiatric Social Worker,,8,Non-strikeable,8220,9174,10243,954,2023,21774,98640,122916
Public Affairs Specialist 2,,8,Non-strikeable,8220,9174,10243,954,2023,21774,98640,122916
Public Health Toxicologist 1,,8,Non-strikeable,8220,9174,10243,954,2023,21774,98640,122916
Public Service Representative 2,,8,Non-strikeable,3959,4418,4921,459,962,11265,47508,59052
Public Service Representative 3,,8,Non-strikeable,4337,4843,5408,506,1071,12197,52044,64896
Public Service Representative 4,,8,Non-strikeable,5492,6128,6844,636,1352,15046,65904,82128
Rehabilitation Instructor For The Blind,,8,Non-strikeable,6318,7056,7876,738,1558,17083,75816,94512
Rehabilitation Instructor For The Blind (Entry),,8,Non-strikeable,5754,6423,7169,669,1415,15692,69048,86028
Research Analyst 1,,8,Non-strikeable,5231,5849,6529,618,1298,14402,62772,78348
Research Analyst 2,,8,Non-strikeable,6318,7056,7876,738,1558,17083,75816,94512
Retirement Counselor 1,,8,Non-strikeable,5492,6128,6844,636,1352,15046,65904,82128
Revenue Agent 1,,8,Non-strikeable,4766,5319,5936,553,1170,13255,57192,71232
Revenue Agent 2,,8,Non-strikeable,5231,5849,6529,618,1298,14402,62772,78348
Revenue Agent 3,,8,Non-strikeable,5754,6423,7169,669,1415,15692,69048,86028
Safety Specialist 1,,8,Non-strikeable,6318,7056,7876,738,1558,17083,75816,94512
Scientific Instrument Technician,,8,Non-strikeable,5754,6423,7169,669,1415,15692,69048,86028
Seamster,,8,Non-strikeable,4337,4843,5408,506,1071,12197,52044,64896
Shipping Point Inspector 1,,8,Non-strikeable,4337,4843,5408,506,1071,12197,52044,64896
Shipping Point Inspector 2,,8,Non-strikeable,4766,5319,5936,553,1170,13255,57192,71232
Sign Technician 1,,8,Non-strikeable,5231,5849,6529,618,1298,14402,62772,78348
Social Service Assistant,,8,Non-strikeable,4766,5319,5936,553,1170,13255,57192,71232
State Library Specialist 1,,8,Non-strikeable,3780,4216,4707,436,927,10823,45360,56484
Supply Specialist 1,,8,Non-strikeable,4148,4619,5160,471,1012,11731,49776,61920
Supply Specialist 2,,8,Non-strikeable,5492,6128,6844,636,1352,15046,65904,82128
Tax Auditor/Entry,,8,Non-strikeable,5492,6128,6844,636,1352,15046,65904,82128
Teaching Assistant,,8,Non-strikeable,4337,4843,5408,506,1071,12197,52044,64896
Training & Development Specialist 1,,8,Non-strikeable,6318,7056,7876,738,1558,17083,75816,94512
Transportation Maintenance Coordinator 1,,8,Non-strikeable,5754,6423,7169,669,1415,15692,69048,86028
Transportation Maintenance Specialist 1,,8,Non-strikeable,4766,5319,5936,553,1170,13255,57192,71232
Transportation Maintenance Specialist 2,,8,Non-strikeable,5231,5849,6529,618,1298,14402,62772,78348
Transportation Services Office Leader,,8,Non-strikeable,5754,6423,7169,669,1415,15692,69048,86028
Transportation Services Representative 1,,8,Non-strikeable,4766,5319,5936,553,1170,13255,57192,71232
Transportation Services Representative 2,,8,Non-strikeable,5231,5849,6529,618,1298,14402,62772,78348
Transportation Telecommunications Specialist 1,,8,Non-strikeable,5492,6128,6844,636,1352,15046,65904,82128
Transporting Mental Health Aide,,8,Non-strikeable,4766,5319,5936,553,1170,13255,57192,71232
Truck Driver 1,,8,Non-strikeable,4766,5319,5936,553,1170,13255,57192,71232
Truck Driver 2,,8,Non-strikeable,5492,6128,6844,636,1352,15046,65904,82128
Veterans Service Officer,,8,Non-strikeable,6318,7056,7876,738,1558,17083,75816,94512
Veterans Trust Officer,,8,Non-strikeable,6318,7056,7876,738,1558,17083,75816,94512
Vocational Rehabilitation Counselor Entry,,8,Non-strikeable,5492,6128,6844,636,1352,15046,65904,82128
Water Resource Data Technician 1,,8,Non-strikeable,5231,5849,6529,618,1298,14402,62772,78348
Water Resource Data Technician 2,,8,Non-strikeable,5754,6423,7169,669,1415,15692,69048,86028
Wildland Fire Dispatcher,,8,Non-strikeable,4337,4843,5408,506,1071,12197,52044,64896
Wildland Fire Dispatcher Entry,,8,Non-strikeable,3604,4026,4493,422,889,10389,43248,53916
Wildland Fire Suppression Specialist,,8,Non-strikeable,4766,5319,5936,553,1170,13255,57192,71232
Wildland Fire Suppression Specialist Entry,,8,Non-strikeable,3959,4418,4921,459,962,11265,47508,59052
Word Processing Technician 2,,8,Non-strikeable,4148,4619,5160,471,1012,11731,49776,61920
Word Processing Technician 3,,8,Non-strikeable,4547,5076,5667,529,1120,12715,54564,68004
Youth Corrections Unit Coordinator,,8,Non-strikeable,6318,7056,7876,738,1558,17083,75816,94512
Accountant 1,,9,Non-strikeable,6625,7056,7518,431,893,17840,79500,90216
Accounting Technician,,9,Non-strikeable,5492,6128,6529,636,1037,15046,65904,78348
Activities Coordinator,,9,Non-strikeable,5492,6128,6529,636,1037,15046,65904,78348
Administrative Specialist 1,,9,Non-strikeable,4994,5571,5936,577,942,13817,59928,71232
Administrative Specialist 2,,9,Non-strikeable,5754,6423,6844,669,1090,15692,69048,82128
Apprenticeship Representative,,9,Non-strikeable,6625,7392,7876,767,1251,17840,79500,94512
Automotive Fleet Attendant,,9,Non-strikeable,4337,4843,5160,506,823,12197,52044,61920
Automotive Technician 1,,9,Non-strikeable,5492,6128,6529,636,1037,15046,65904,78348
Automotive Technician 2,,9,Non-strikeable,6625,7392,7876,767,1251,17840,79500,94512
Behavioral Health Specialist 3,,9,Non-strikeable,8614,9614,10243,1000,1629,22746,103368,122916
Biological Science Assistant,,9,Non-strikeable,3959,4418,4707,459,748,11265,47508,56484
Business & Employment Specialist 2,,9,Non-strikeable,6031,6729,7169,698,1138,16375,72372,86028
Certified Occupation Therapist Assistant,,9,Non-strikeable,5754,6423,6844,669,1090,15692,69048,82128
Chemist 3,,9,Non-strikeable,8614,9614,10243,1000,1629,22746,103368,122916
Child Support Case Manager,,9,Non-strikeable,6031,6729,7169,698,1138,16375,72372,86028
Child Support Case Manager Entry,,9,Non-strikeable,5492,6128,6529,636,1037,15046,65904,78348
Child Support Specialist,,9,Non-strikeable,6625,7392,7876,767,1251,17840,79500,94512
Civil Rights Investigator 1,,9,Non-strikeable,6031,6729,7169,698,1138,16375,72372,86028
Compliance Specialist 1,,9,Non-strikeable,6031,6729,7169,698,1138,16375,72372,86028
Compliance Specialist 3,,9,Non-strikeable,8614,9614,10243,1000,1629,22746,103368,122916
Cook,,9,Non-strikeable,4994,5571,5936,577,942,13817,59928,71232
Custodial Services Coordinator,,9,Non-strikeable,4148,4619,4921,471,773,11731,49776,59052
Data Entry Control Technician,,9,Non-strikeable,3959,4418,4707,459,748,11265,47508,56484
Data Entry Operator,,9,Non-strikeable,3959,4418,4707,459,748,11265,47508,56484
Dental Assistant 2,,9,Non-strikeable,5754,6423,6844,669,1090,15692,69048,82128
Dental Hygienist,,9,Non-strikeable,8614,9614,10243,1000,1629,22746,103368,122916
Disability Analyst 1,,9,Non-strikeable,6625,7392,7876,767,1251,17840,79500,94512
District Veterinarian,,9,Non-strikeable,8614,9614,10243,1000,1629,22746,103368,122916
Dormitory Counselor 1,,9,Non-strikeable,4766,5319,5667,553,901,13255,57192,68004
Dormitory Counselor 2,,9,Non-strikeable,5754,6423,6844,669,1090,15692,69048,82128
Economist 1,,9,Non-strikeable,6625,7392,7876,767,1251,17840,79500,94512
Electronic Publishing Design Specialist 1,,9,Non-strikeable,4994,5571,5936,577,942,13817,59928,71232
Employment Adjudicator,,9,Non-strikeable,6625,7392,7876,767,1251,17840,79500,94512
Employment Appeals Board Legal Staff,,9,Non-strikeable,8614,9614,10243,1000,1629,22746,103368,122916
Engineering Technician 2,,9,Non-strikeable,5492,6128,6529,636,1037,15046,65904,78348
Engineering Technician 3,,9,Non-strikeable,6031,6729,7169,698,1138,16375,72372,86028
Equipment Operator,,9,Non-strikeable,6031,6729,7169,698,1138,16375,72372,86028
Executive Support Specialist 1,,9,Non-strikeable,4994,5571,5936,577,942,13817,59928,71232
Executive Support Specialist 2,,9,Non-strikeable,5754,6423,6844,669,1090,15692,69048,82128
Facility Energy Technician 4,,9,Non-strikeable,8614,9614,10243,1000,1629,22746,103368,122916
Fiscal Analyst 1,,9,Non-strikeable,6625,7392,7876,767,1251,17840,79500,94512
Fiscal Auditor 1,,9,Non-strikeable,6625,7392,7876,767,1251,17840,79500,94512
Fish and Wildlife Technical Coordinator,,9,Non-strikeable,6031,6729,7169,698,1138,16375,72372,86028
Fish and Wildlife Technician,,9,Non-strikeable,4994,5571,5936,577,942,13817,59928,71232
Fish and Wildlife Technician Entry,,9,Non-strikeable,4148,4619,4921,471,773,11731,49776,59052
Fish and Wildlife Technician Senior,,9,Non-strikeable,5492,6128,6529,636,1037,15046,65904,78348
Food Service Worker,,9,Non-strikeable,4148,4619,4921,471,773,11731,49776,59052
Forest Crew Coordinator,,9,Non-strikeable,5492,6128,6529,636,1037,15046,65904,78348
Forest Lookout,,9,Non-strikeable,3780,4216,4493,436,713,10823,45360,53916
Forest Management Technician,,9,Non-strikeable,4766,5319,5667,553,901,13255,57192,68004
Forest Officer,,9,Non-strikeable,6625,7392,7876,767,1251,17840,79500,94512
Governmental Auditor 3,,9,Non-strikeable,8614,9614,10243,1000,1629,22746,103368,122916
Grounds Maintenance Worker 1,,9,Non-strikeable,4337,4843,5160,506,823,12197,52044,61920
Grounds Maintenance Worker 2,,9,Non-strikeable,4994,5571,5936,577,942,13817,59928,71232
Group Life Coordinator 1,,9,Non-strikeable,4547,5076,5408,529,861,12715,54564,64896
Group Life Coordinator 2,,9,Non-strikeable,5492,6128,6529,636,1037,15046,65904,78348
Human Services Assistant 2,,9,Non-strikeable,4766,5319,5667,553,901,13255,57192,68004
Human Services Case Manager,,9,Non-strikeable,6031,6729,7169,698,1138,16375,72372,86028
Human Services Specialist 1,,9,Non-strikeable,4547,5076,5408,529,861,12715,54564,64896
Human Services Specialist 2,,9,Non-strikeable,4994,5571,5936,577,942,13817,59928,71232
Human Services Specialist 3,,9,Non-strikeable,5492,6128,6529,636,1037,15046,65904,78348
Incident Response Operations Specialist,,9,Non-strikeable,5754,6423,6844,669,1090,15692,69048,82128
Industrial Hygienist 3,,9,Non-strikeable,8614,9614,10243,1000,1629,22746,103368,122916
Information Systems Specialist 2,,9,Non-strikeable,6031,6729,7169,698,1138,16375,72372,86028
Information Systems Specialist 6,,9,Non-strikeable,8614,9614,10243,1000,1629,22746,103368,122916
Information Systems Specialist 7,,9,Non-strikeable,8614,9614,10243,1000,1629,22746,103368,122916
Investigator 1,,9,Non-strikeable,5492,6128,6529,636,1037,15046,65904,78348
Investigator 2,,9,Non-strikeable,6625,7392,7876,767,1251,17840,79500,94512
Laboratory Technician 2,,9,Non-strikeable,4994,5571,5936,577,942,13817,59928,71232
Laborer/Student Worker,,9,Non-strikeable,3959,4418,4707,459,748,11265,47508,56484
Licensed Practical Nurse,,9,Non-strikeable,5716,6355,6771,639,1055,15598,68592,81252
Livestock Brand Inspector,,9,Non-strikeable,4547,5076,5408,529,861,12715,54564,64896
Loan Specialist 1,,9,Non-strikeable,6625,7392,7876,767,1251,17840,79500,94512
Mail Delivery Driver,,9,Non-strikeable,4547,5076,5408,529,861,12715,54564,64896
Mail Equipment Operator 1,,9,Non-strikeable,3959,4418,4707,459,748,11265,47508,56484
Mail Equipment Operator 2,,9,Non-strikeable,4547,5076,5408,529,861,12715,54564,64896
Mail Services Assistant,,9,Non-strikeable,4148,4619,4921,471,773,11731,49776,59052
Manual Arts Instructor,,9,Non-strikeable,4994,5571,5936,577,942,13817,59928,71232
Medical Laboratory Technician 2,,9,Non-strikeable,5754,6423,6844,669,1090,15692,69048,82128
Mental Health Security Technician,,9,Non-strikeable,4994,5571,5936,577,942,13817,59928,71232
Mental Health Therapist 1,,9,Non-strikeable,4994,5571,5936,577,942,13817,59928,71232
Mental Health Therapist 2,,9,Non-strikeable,5492,6128,6529,636,1037,15046,65904,78348
Mental Health Therapy Coordinator,,9,Non-strikeable,5492,6128,6529,636,1037,15046,65904,78348
Mental Health Therapy Technician,,9,Non-strikeable,4547,5076,5408,529,861,12715,54564,64896
Microbiologist 1,,9,Non-strikeable,6625,7392,7876,767,1251,17840,79500,94512
Motor Carrier Enforcement Officer 1,,9,Non-strikeable,6031,6729,7169,698,1138,16375,72372,86028
Natural Resource Specialist 1,,9,Non-strikeable,6031,6729,7169,698,1138,16375,72372,86028
Nutrition Consultant,,9,Non-strikeable,8614,9614,10243,1000,1629,22746,103368,122916
Occupational Safety Specialist 3,,9,Non-strikeable,8614,9614,10243,1000,1629,22746,103368,122916
Office Coordinator,,9,Non-strikeable,4547,5076,5408,529,861,12715,54564,64896
Office Specialist 1,,9,Non-strikeable,4148,4619,4921,471,773,11731,49776,59052
Office Specialist 2,,9,Non-strikeable,4547,5076,5408,529,861,12715,54564,64896
Operations & Policy Analyst 1,,9,Non-strikeable,6625,7392,7876,767,1251,17840,79500,94512
Park Ranger 2,,9,Non-strikeable,5754,6423,6844,669,1090,15692,69048,82128
Park Ranger Assistant,,9,Non-strikeable,3959,4418,4707,459,748,11265,47508,56484
Park Specialist,,9,Non-strikeable,4994,5571,5936,577,942,13817,59928,71232
Parking Services Representative,,9,Non-strikeable,4337,4843,5160,506,823,12197,52044,61920
Parts Specialist 2,,9,Non-strikeable,5754,6423,6844,669,1090,15692,69048,82128
Payroll Analyst,,9,Non-strikeable,6031,6729,7169,698,1138,16375,72372,86028
Pharmacist Resident,,9,Non-strikeable,6625,7392,7876,767,1251,17840,79500,94512
Pharmacy Clerk & Technician 2,,9,Non-strikeable,4766,5319,5667,553,901,13255,57192,68004
Pharmacy Clerk & Technician 3,,9,Non-strikeable,4994,5571,5936,577,942,13817,59928,71232
Physical/Electronic Security Technician,,9,Non-strikeable,5754,6423,6844,669,1090,15692,69048,82128
Print Services Technician,,9,Non-strikeable,4766,5319,5667,553,901,13255,57192,68004
Printing Production Coordinator,,9,Non-strikeable,6625,7392,7876,767,1251,17840,79500,94512
Procurement & Contract Specialist 1,,9,Non-strikeable,6625,7392,7876,767,1251,17840,79500,94512
Procurement & Contract Specialist 3,,9,Non-strikeable,8614,9614,10243,1000,1629,22746,103368,122916
Procurement And Contract Assistant,,9,Non-strikeable,5492,6128,6529,636,1037,15046,65904,78348
Program Analyst 1,,9,Non-strikeable,6625,7392,7876,767,1251,17840,79500,94512
Program Analyst 3,,9,Non-strikeable,8614,9614,10243,1000,1629,22746,103368,122916
Psychiatric Social Worker,,9,Non-strikeable,8614,9614,10243,1000,1629,22746,103368,122916
Public Affairs Specialist 2,,9,Non-strikeable,8614,9614,10243,1000,1629,22746,103368,122916
Public Health Toxicologist 1,,9,Non-strikeable,8614,9614,10243,1000,1629,22746,103368,122916
Public Service Representative 2,,9,Non-strikeable,4148,4619,4921,471,773,11731,49776,59052
Public Service Representative 3,,9,Non-strikeable,4547,5076,5408,529,861,12715,54564,64896
Public Service Representative 4,,9,Non-strikeable,5754,6423,6844,669,1090,15692,69048,82128
Rehabilitation Instructor For The Blind,,9,Non-strikeable,6625,7392,7876,767,1251,17840,79500,94512
Rehabilitation Instructor For The Blind (Entry),,9,Non-strikeable,6031,6729,7169,698,1138,16375,72372,86028
Research Analyst 1,,9,Non-strikeable,5492,6128,6529,636,1037,15046,65904,78348
Research Analyst 2,,9,Non-strikeable,6625,7392,7876,767,1251,17840,79500,94512
Retirement Counselor 1,,9,Non-strikeable,5754,6423,6844,669,1090,15692,69048,82128
Revenue Agent 1,,9,Non-strikeable,4994,5571,5936,577,942,13817,59928,71232
Revenue Agent 2,,9,Non-strikeable,5492,6128,6529,636,1037,15046,65904,78348
Revenue Agent 3,,9,Non-strikeable,6031,6729,7169,698,1138,16375,72372,86028
Safety Specialist 1,,9,Non-strikeable,6625,7392,7876,767,1251,17840,79500,94512
Scientific Instrument Technician,,9,Non-strikeable,6031,6729,7169,698,1138,16375,72372,86028
Seamster,,9,Non-strikeable,4547,5076,5408,529,861,12715,54564,64896
Shipping Point Inspector 1,,9,Non-strikeable,4547,5076,5408,529,861,12715,54564,64896
Shipping Point Inspector 2,,9,Non-strikeable,4994,5571,5936,577,942,13817,59928,71232
Sign Technician 1,,9,Non-strikeable,5492,6128,6529,636,1037,15046,65904,78348
Social Service Assistant,,9,Non-strikeable,4994,5571,5936,577,942,13817,59928,71232
State Library Specialist 1,,9,Non-strikeable,3959,4418,4707,459,748,11265,47508,56484
Supply Specialist 1,,9,Non-strikeable,4337,4843,5160,506,823,12197,52044,61920
Supply Specialist 2,,9,Non-strikeable,5754,6423,6844,669,1090,15692,69048,82128
Tax Auditor/Entry,,9,Non-strikeable,5754,6423,6844,669,1090,15692,69048,82128
Teaching Assistant,,9,Non-strikeable,4547,5076,5408,529,861,12715,54564,64896
Training & Development Specialist 1,,9,Non-strikeable,6625,7392,7876,767,1251,17840,79500,94512
Transportation Maintenance Coordinator 1,,9,Non-strikeable,6031,6729,7169,698,1138,16375,72372,86028
Transportation Maintenance Specialist 1,,9,Non-strikeable,4994,5571,5936,577,942,13817,59928,71232
Transportation Maintenance Specialist 2,,9,Non-strikeable,5492,6128,6529,636,1037,15046,65904,78348
Transportation Services Office Leader,,9,Non-strikeable,6031,6729,7169,698,1138,16375,72372,86028
Transportation Services Representative 1,,9,Non-strikeable,4994,5571,5936,577,942,13817,59928,71232
Transportation Services Representative 2,,9,Non-strikeable,5492,6128,6529,636,1037,15046,65904,78348
Transportation Telecommunications Specialist 1,,9,Non-strikeable,5754,6423,6844,669,1090,15692,69048,82128
Transporting Mental Health Aide,,9,Non-strikeable,4994,5571,5936,577,942,13817,59928,71232
Truck Driver 1,,9,Non-strikeable,4994,5571,5936,577,942,13817,59928,71232
Truck Driver 2,,9,Non-strikeable,5754,6423,6844,669,1090,15692,69048,82128
Veterans Service Officer,,9,Non-strikeable,6625,7392,7876,767,1251,17840,79500,94512
Veterans Trust Officer,,9,Non-strikeable,6625,7392,7876,767,1251,17840,79500,94512
Vocational Rehabilitation Counselor Entry,,9,Non-strikeable,5754,6423,6844,669,1090,15692,69048,82128
Water Resource Data Technician 1,,9,Non-strikeable,5492,6128,6529,636,1037,15046,65904,78348
Water Resource Data Technician 2,,9,Non-strikeable,6031,6729,7169,698,1138,16375,72372,86028
Wildland Fire Dispatcher,,9,Non-strikeable,4547,5076,5408,529,861,12715,54564,64896
Wildland Fire Dispatcher Entry,,9,Non-strikeable,3780,4216,4493,436,713,10823,45360,53916
Wildland Fire Suppression Specialist,,9,Non-strikeable,4994,5571,5936,577,942,13817,59928,71232
Wildland Fire Suppression Specialist Entry,,9,Non-strikeable,4148,4619,4921,471,773,11731,49776,59052
Word Processing Technician 2,,9,Non-strikeable,4337,4843,5160,506,823,12197,52044,61920
Word Processing Technician 3,,9,Non-strikeable,4766,5319,5667,553,901,13255,57192,68004
Youth Corrections Unit Coordinator,,9,Non-strikeable,6625,7392,7876,767,1251,17840,79500,94512
Accountant 1,,10,Non-strikeable,6941,7392,7876,451,935,18619,83292,94512
Accounting Technician,,10,Non-strikeable,5754,6128,6529,374,775,15692,69048,78348
Activities Coordinator,,10,Non-strikeable,5754,6128,6529,374,775,15692,69048,78348
Administrative Specialist 1,,10,Non-strikeable,5231,5571,5936,340,705,14402,62772,71232
Administrative Specialist 2,,10,Non-strikeable,6031,6423,6844,392,813,16375,72372,82128
Apprenticeship Representative,,10,Non-strikeable,6941,7392,7876,451,935,18619,83292,94512
Automotive Fleet Attendant,,10,Non-strikeable,4547,4843,5160,296,613,12715,54564,61920
Automotive Technician 1,,10,Non-strikeable,5754,6128,6529,374,775,15692,69048,78348
Automotive Technician 2,,10,Non-strikeable,6941,7392,7876,451,935,18619,83292,94512
Behavioral Health Specialist 3,,10,Non-strikeable,9027,9614,10243,587,1216,23764,108324,122916
Biological Science Assistant,,10,Non-strikeable,4148,4418,4707,270,559,11731,49776,56484
Business & Employment Specialist 2,,10,Non-strikeable,6318,6729,7169,411,851,17083,75816,86028
Certified Occupation Therapist Assistant,,10,Non-strikeable,6031,6423,6844,392,813,16375,72372,82128
Chemist 3,,10,Non-strikeable,9027,9614,10243,587,1216,23764,108324,122916
Child Support Case Manager,,10,Non-strikeable,6318,6729,7169,411,851,17083,75816,86028
Child Support Case Manager Entry,,10,Non-strikeable,5754,6128,6529,374,775,15692,69048,78348
Child Support Specialist,,10,Non-strikeable,6941,7392,7876,451,935,18619,83292,94512
Civil Rights Investigator 1,,10,Non-strikeable,6318,6729,7169,411,851,17083,75816,86028
Compliance Specialist 1,,10,Non-strikeable,6318,6729,7169,411,851,17083,75816,86028
Compliance Specialist 3,,10,Non-strikeable,9027,9614,10243,587,1216,23764,108324,122916
Cook,,10,Non-strikeable,5231,5571,5936,340,705,14402,62772,71232
Custodial Services Coordinator,,10,Non-strikeable,4337,4619,4921,282,584,12197,52044,59052
Data Entry Control Technician,,10,Non-strikeable,4148,4418,4707,270,559,11731,49776,56484
Data Entry Operator,,10,Non-strikeable,4148,4418,4707,270,559,11731,49776,56484
Dental Assistant 2,,10,Non-strikeable,6031,6423,6844,392,813,16375,72372,82128
Dental Hygienist,,10,Non-strikeable,9027,9614,10243,587,1216,23764,108324,122916
Disability Analyst 1,,10,Non-strikeable,6941,7392,7876,451,935,18619,83292,94512
District Veterinarian,,10,Non-strikeable,9027,9614,10243,587,1216,23764,108324,122916
Dormitory Counselor 1,,10,Non-strikeable,4994,5319,5667,325,673,13817,59928,68004
Dormitory Counselor 2,,10,Non-strikeable,6031,6423,6844,392,813,16375,72372,82128
Economist 1,,10,Non-strikeable,6941,7392,7876,451,935,18619,83292,94512
Electronic Publishing Design Specialist 1,,10,Non-strikeable,5231,5571,5936,340,705,14402,62772,71232
Employment Adjudicator,,10,Non-strikeable,6941,7392,7876,451,935,18619,83292,94512
Employment Appeals Board Legal Staff,,10,Non-strikeable,9027,9614,10243,587,1216,23764,108324,122916
Engineering Technician 2,,10,Non-strikeable,5754,6128,6529,374,775,15692,69048,78348
Engineering Technician 3,,10,Non-strikeable,6318,6729,7169,411,851,17083,75816,86028
Equipment Operator,,10,Non-strikeable,6318,6729,7169,411,851,17083,75816,86028
Executive Support Specialist 1,,10,Non-strikeable,5231,5571,5936,340,705,14402,62772,71232
Executive Support Specialist 2,,10,Non-strikeable,6031,6423,6844,392,813,16375,72372,82128
Facility Energy Technician 4,,10,Non-strikeable,9027,9614,10243,587,1216,23764,108324,122916
Fiscal Analyst 1,,10,Non-strikeable,6941,7392,7876,451,935,18619,83292,94512
Fiscal Auditor 1,,10,Non-strikeable,6941,7392,7876,451,935,18619,83292,94512
Fish and Wildlife Technical Coordinator,,10,Non-strikeable,6318,6729,7169,411,851,17083,75816,86028
Fish and Wildlife Technician,,10,Non-strikeable,5231,5571,5936,340,705,14402,62772,71232
Fish and Wildlife Technician Entry,,10,Non-strikeable,4337,4619,4921,282,584,12197,52044,59052
Fish and Wildlife Technician Senior,,10,Non-strikeable,5754,6128,6529,374,775,15692,69048,78348
Food Service Worker,,10,Non-strikeable,4337,4619,4921,282,584,12197,52044,59052
Forest Crew Coordinator,,10,Non-strikeable,5754,6128,6529,374,775,15692,69048,78348
Forest Lookout,,10,Non-strikeable,3959,4216,4493,257,534,11265,47508,53916
Forest Management Technician,,10,Non-strikeable,4994,5319,5667,325,673,13817,59928,68004
Forest Officer,,10,Non-strikeable,6941,7392,7876,451,935,18619,83292,94512
Governmental Auditor 3,,10,Non-strikeable,9027,9614,10243,587,1216,23764,108324,122916
Grounds Maintenance Worker 1,,10,Non-strikeable,4547,4843,5160,296,613,12715,54564,61920
Grounds Maintenance Worker 2,,10,Non-strikeable,5231,5571,5936,340,705,14402,62772,71232
Group Life Coordinator 1,,10,Non-strikeable,4766,5076,5408,310,642,13255,57192,64896
Group Life Coordinator 2,,10,Non-strikeable,5754,6128,6529,374,775,15692,69048,78348
Human Services Assistant 2,,10,Non-strikeable,4994,5319,5667,325,673,13817,59928,68004
Human Services Case Manager,,10,Non-strikeable,6318,6729,7169,411,851,17083,75816,86028
Human Services Specialist 1,,10,Non-strikeable,4766,5076,5408,310,642,13255,57192,64896
Human Services Specialist 2,,10,Non-strikeable,5231,5571,5936,340,705,14402,62772,71232
Human Services Specialist 3,,10,Non-strikeable,5754,6128,6529,374,775,15692,69048,78348
Incident Response Operations Specialist,,10,Non-strikeable,6031,6423,6844,392,813,16375,72372,82128
Industrial Hygienist 3,,10,Non-strikeable,9027,9614,10243,587,1216,23764,108324,122916
Information Systems Specialist 2,,10,Non-strikeable,6318,6729,7169,411,851,17083,75816,86028
Information Systems Specialist 6,,10,Non-strikeable,9027,9614,10243,587,1216,23764,108324,122916
Information Systems Specialist 7,,10,Non-strikeable,9027,9614,10243,587,1216,23764,108324,122916
Investigator 1,,10,Non-strikeable,5754,6128,6529,374,775,15692,69048,78348
Investigator 2,,10,Non-strikeable,6941,7392,7876,451,935,18619,83292,94512
Laboratory Technician 2,,10,Non-strikeable,5231,5571,5936,340,705,14402,62772,71232
Laborer/Student Worker,,10,Non-strikeable,4148,4418,4707,270,559,11731,49776,56484
Licensed Practical Nurse,,10,Non-strikeable,5967,6355,6771,388,804,16217,71604,81252
Livestock Brand Inspector,,10,Non-strikeable,4766,5076,5408,310,642,13255,57192,64896
Loan Specialist 1,,10,Non-strikeable,6941,7392,7876,451,935,18619,83292,94512
Mail Delivery Driver,,10,Non-strikeable,4766,5076,5408,310,642,13255,57192,64896
Mail Equipment Operator 1,,10,Non-strikeable,4148,4418,4707,270,559,11731,49776,56484
Mail Equipment Operator 2,,10,Non-strikeable,4766,5076,5408,310,642,13255,57192,64896
Mail Services Assistant,,10,Non-strikeable,4337,4619,4921,282,584,12197,52044,59052
Manual Arts Instructor,,10,Non-strikeable,5231,5571,5936,340,705,14402,62772,71232
Medical Laboratory Technician 2,,10,Non-strikeable,6031,6423,6844,392,813,16375,72372,82128
Mental Health Security Technician,,10,Non-strikeable,5231,5571,5936,340,705,14402,62772,71232
Mental Health Therapist 1,,10,Non-strikeable,5231,5571,5936,340,705,14402,62772,71232
Mental Health Therapist 2,,10,Non-strikeable,5754,6128,6529,374,775,15692,69048,78348
Mental Health Therapy Coordinator,,10,Non-strikeable,5754,6128,6529,374,775,15692,69048,78348
Mental Health Therapy Technician,,10,Non-strikeable,4766,5076,5408,310,642,13255,57192,64896
Microbiologist 1,,10,Non-strikeable,6941,7392,7876,451,935,18619,83292,94512
Motor Carrier Enforcement Officer 1,,10,Non-strikeable,6318,6729,7169,411,851,17083,75816,86028
Natural Resource Specialist 1,,10,Non-strikeable,6318,6729,7169,411,851,17083,75816,86028
Nutrition Consultant,,10,Non-strikeable,9027,9614,10243,587,1216,23764,108324,122916
Occupational Safety Specialist 3,,10,Non-strikeable,9027,9614,10243,587,1216,23764,108324,122916
Office Coordinator,,10,Non-strikeable,4766,5076,5408,310,642,13255,57192,64896
Office Specialist 1,,10,Non-strikeable,4337,4619,4921,282,584,12197,52044,59052
Office Specialist 2,,10,Non-strikeable,4766,5076,5408,310,642,13255,57192,64896
Operations & Policy Analyst 1,,10,Non-strikeable,6941,7392,7876,451,935,18619,83292,94512
Park Ranger 2,,10,Non-strikeable,6031,6423,6844,392,813,16375,72372,82128
Park Ranger Assistant,,10,Non-strikeable,4148,4418,4707,270,559,11731,49776,56484
Park Specialist,,10,Non-strikeable,5231,5571,5936,340,705,14402,62772,71232
Parking Services Representative,,10,Non-strikeable,4547,4843,5160,296,613,12715,54564,61920
Parts Specialist 2,,10,Non-strikeable,6031,6423,6844,392,813,16375,72372,82128
Payroll Analyst,,10,Non-strikeable,6318,6729,7169,411,851,17083,75816,86028
Pharmacist Resident,,10,Non-strikeable,6941,7392,7876,451,935,18619,83292,94512
Pharmacy Clerk & Technician 2,,10,Non-strikeable,4994,5319,5667,325,673,13817,59928,68004
Pharmacy Clerk & Technician 3,,10,Non-strikeable,5231,5571,5936,340,705,14402,62772,71232
Physical/Electronic Security Technician,,10,Non-strikeable,6031,6423,6844,392,813,16375,72372,82128
Print Services Technician,,10,Non-strikeable,4994,5319,5667,325,673,13817,59928,68004
Printing Production Coordinator,,10,Non-strikeable,6941,7392,7876,451,935,18619,83292,94512
Procurement & Contract Specialist 1,,10,Non-strikeable,6941,7392,7876,451,935,18619,83292,94512
Procurement & Contract Specialist 3,,10,Non-strikeable,9027,9614,10243,587,1216,23764,108324,122916
Procurement And Contract Assistant,,10,Non-strikeable,5754,6128,6529,374,775,15692,69048,78348
Program Analyst 1,,10,Non-strikeable,6941,7392,7876,451,935,18619,83292,94512
Program Analyst 3,,10,Non-strikeable,9027,9614,10243,587,1216,23764,108324,122916
Psychiatric Social Worker,,10,Non-strikeable,9027,9614,10243,587,1216,23764,108324,122916
Public Affairs Specialist 2,,10,Non-strikeable,9027,9614,10243,587,1216,23764,108324,122916
Public Health Toxicologist 1,,10,Non-strikeable,9027,9614,10243,587,1216,23764,108324,122916
Public Service Representative 2,,10,Non-strikeable,4337,4619,4921,282,584,12197,52044,59052
Public Service Representative 3,,10,Non-strikeable,4766,5076,5408,310,642,13255,57192,64896
Public Service Representative 4,,10,Non-strikeable,6031,6423,6844,392,813,16375,72372,82128
Rehabilitation Instructor For The Blind,,10,Non-strikeable,6941,7392,7876,451,935,18619,83292,94512
Rehabilitation Instructor For The Blind (Entry),,10,Non-strikeable,6318,6729,7169,411,851,17083,75816,86028
Research Analyst 1,,10,Non-strikeable,5754,6128,6529,374,775,15692,69048,78348
Research Analyst 2,,10,Non-strikeable,6941,7392,7876,451,935,18619,83292,94512
Retirement Counselor 1,,10,Non-strikeable,6031,6423,6844,392,813,16375,72372,82128
Revenue Agent 1,,10,Non-strikeable,5231,5571,5936,340,705,14402,62772,71232
Revenue Agent 2,,10,Non-strikeable,5754,6128,6529,374,775,15692,69048,78348
Revenue Agent 3,,10,Non-strikeable,6318,6729,7169,411,851,17083,75816,86028
Safety Specialist 1,,10,Non-strikeable,6941,7392,7876,451,935,18619,83292,94512
Scientific Instrument Technician,,10,Non-strikeable,6318,6729,7169,411,851,17083,75816,86028
Seamster,,10,Non-strikeable,4766,5076,5408,310,642,13255,57192,64896
Shipping Point Inspector 1,,10,Non-strikeable,4766,5076,5408,310,642,13255,57192,64896
Shipping Point Inspector 2,,10,Non-strikeable,5231,5571,5936,340,705,14402,62772,71232
Sign Technician 1,,10,Non-strikeable,5754,6128,6529,374,775,15692,69048,78348
Social Service Assistant,,10,Non-strikeable,5231,5571,5936,340,705,14402,62772,71232
State Library Specialist 1,,10,Non-strikeable,4148,4418,4707,270,559,11731,49776,56484
Supply Specialist 1,,10,Non-strikeable,4547,4843,5160,296,613,12715,54564,61920
Supply Specialist 2,,10,Non-strikeable,6031,6423,6844,392,813,16375,72372,82128
Tax Auditor/Entry,,10,Non-strikeable,6031,6423,6844,392,813,16375,72372,82128
Teaching Assistant,,10,Non-strikeable,4766,5076,5408,310,642,13255,57192,64896
Training & Development Specialist 1,,10,Non-strikeable,6941,7392,7876,451,935,18619,83292,94512
Transportation Maintenance Coordinator 1,,10,Non-strikeable,6318,6729,7169,411,851,17083,75816,86028
Transportation Maintenance Specialist 1,,10,Non-strikeable,5231,5571,5936,340,705,14402,62772,71232
Transportation Maintenance Specialist 2,,10,Non-strikeable,5754,6128,6529,374,775,15692,69048,78348
Transportation Services Office Leader,,10,Non-strikeable,6318,6729,7169,411,851,17083,75816,86028
Transportation Services Representative 1,,10,Non-strikeable,5231,5571,5936,340,705,14402,62772,71232
Transportation Services Representative 2,,10,Non-strikeable,5754,6128,6529,374,775,15692,69048,78348
Transportation Telecommunications Specialist 1,,10,Non-strikeable,6031,6423,6844,392,813,16375,72372,82128
Transporting Mental Health Aide,,10,Non-strikeable,5231,5571,5936,340,705,14402,62772,71232
Truck Driver 1,,10,Non-strikeable,5231,5571,5936,340,705,14402,62772,71232
Truck Driver 2,,10,Non-strikeable,6031,6423,6844,392,813,16375,72372,82128
Veterans Service Officer,,10,Non-strikeable,6941,7392,7876,451,935,18619,83292,94512
Veterans Trust Officer,,10,Non-strikeable,6941,7392,7876,451,935,18619,83292,94512
Vocational Rehabilitation Counselor Entry,,10,Non-strikeable,6031,6423,6844,392,813,16375,72372,82128
Water Resource Data Technician 1,,10,Non-strikeable,5754,6128,6529,374,775,15692,69048,78348
Water Resource Data Technician 2,,10,Non-strikeable,6318,6729,7169,411,851,17083,75816,86028
Wildland Fire Dispatcher,,10,Non-strikeable,4766,5076,5408,310,642,13255,57192,64896
Wildland Fire Dispatcher Entry,,10,Non-strikeable,3959,4216,4493,257,534,11265,47508,53916
Wildland Fire Suppression Specialist,,10,Non-strikeable,5231,5571,5936,340,705,14402,62772,71232
Wildland Fire Suppression Specialist Entry,,10,Non-strikeable,4337,4619,4921,282,584,12197,52044,59052
Word Processing Technician 2,,10,Non-strikeable,4547,4843,5160,296,613,12715,54564,61920
Word Processing Technician 3,,10,Non-strikeable,4994,5319,5667,325,673,13817,59928,68004
Youth Corrections Unit Coordinator,,10,Non-strikeable,6941,7392,7876,451,935,18619,83292,94512